4 4 4 4 4 4 4 4 4 4 4 4 4 4 4 4 4 4 4 4 4 4 4 4 4 4 4 4 4 4 4 4 4 4 4 4 4 4 4 4 4 4 4 4 4 4 4 4 4 4 4 4 4 4 4 4 4 4 4 4 4 4 4 4 4 4 4 4 4 4 4 4 4 4 4 4 4 4 4 4 4 4 4 4 4 4 4 4 4 4 4 4 4 4 4 4 4 4 4 4 
4 4 4 4 4 4 4 4 4 4 4 4 4 4 4 4 4 4 4 4 4 4 4 4 4 4 4 4 4 4 4 4 4 4 4 4 4 4 4 4 4 4 4 4 4 4 4 4 4 4 4 4 4 4 4 4 4 4 4 4 4 4 4 4 4 4 4 4 4 4 4 4 4 4 4 4 4 4 4 4 4 4 4 4 4 4 4 4 4 4 4 4 4 4 4 4 4 4 4 4 
4 4 4 4 4 4 4 4 4 4 4 4 4 4 4 4 4 4 4 4 4 4 4 4 4 4 4 4 4 4 4 4 4 4 4 4 4 4 4 4 4 4 4 4 4 4 4 4 4 4 4 4 4 4 4 4 4 4 4 4 4 4 4 4 4 4 4 4 4 4 4 4 4 4 4 4 4 4 4 4 4 4 4 4 4 4 4 4 4 4 4 4 4 4 4 4 4 4 4 4 
4 4 4 4 4 4 4 4 4 4 4 4 4 4 4 4 4 4 4 4 4 4 4 4 4 4 4 4 4 4 4 4 4 4 4 4 4 4 4 4 4 4 4 4 4 4 4 4 4 4 4 4 4 4 4 4 4 4 4 4 4 4 4 4 4 4 4 4 4 4 4 4 4 4 4 4 4 4 4 4 4 4 4 4 4 4 4 4 4 4 4 4 4 4 4 4 4 4 4 4 
4 4 4 4 4 4 4 4 4 4 4 4 4 4 4 4 4 4 4 4 4 4 4 4 4 4 4 4 4 4 4 4 4 4 4 4 4 4 4 4 4 4 4 4 4 4 4 4 4 4 4 4 4 4 4 4 4 4 4 4 4 4 4 4 4 4 4 4 4 4 4 4 4 4 4 4 4 4 4 4 4 4 4 4 4 4 4 4 4 4 4 4 4 4 4 4 4 4 4 4 
4 4 4 4 4 4 4 20 20 20 20 20 20 20 20 20 20 20 20 20 20 20 20 20 20 20 20 20 20 20 20 20 20 20 20 20 20 20 20 20 20 20 20 20 20 20 20 20 20 20 20 20 20 20 20 20 20 20 20 20 20 20 20 20 5 5 39 39 39 39 39 39 39 39 20 20 20 20 20 20 20 20 20 20 20 20 20 20 20 20 20 20 20 20 20 20 4 4 4 4 
4 4 4 4 4 4 4 20 20 20 20 20 20 20 20 20 20 20 20 20 20 20 20 20 20 20 20 20 20 20 20 20 20 20 20 20 20 20 20 20 20 20 20 20 20 20 20 20 20 20 20 20 20 20 20 20 20 20 20 20 20 20 20 20 5 5 39 39 39 39 39 39 39 39 20 20 20 20 20 5 20 20 20 20 20 20 20 20 20 20 20 20 20 20 20 20 4 4 4 4 
4 4 4 4 4 4 4 20 20 20 20 20 20 20 20 20 20 20 5 20 20 20 20 20 20 20 20 20 20 20 20 20 20 20 20 20 20 20 20 20 20 20 20 20 20 20 20 20 20 20 20 20 20 20 20 20 20 20 20 20 20 20 20 20 5 39 39 39 39 39 39 39 39 39 5 20 20 5 5 5 5 5 5 20 20 20 20 20 20 20 20 20 20 20 20 20 4 4 4 4 
4 4 4 4 4 4 4 20 20 20 20 20 20 20 20 20 20 20 20 20 20 20 20 20 5 20 20 20 20 20 20 20 20 20 20 20 20 20 5 20 20 20 20 20 20 20 20 20 20 20 20 20 20 20 20 20 20 20 20 5 5 5 5 5 5 39 39 39 39 39 39 39 39 5 5 5 5 5 5 5 5 5 5 5 5 5 20 20 20 20 20 20 20 20 20 20 4 4 4 4 
4 4 4 4 4 4 4 20 5 5 5 5 5 5 5 5 5 5 5 5 5 5 5 5 5 5 5 5 5 5 5 5 5 5 5 5 5 5 5 5 5 5 5 5 5 5 5 5 5 5 5 5 5 5 5 5 5 5 5 5 5 5 5 5 5 39 39 39 39 39 39 39 5 5 5 5 5 5 5 5 5 5 5 5 20 20 20 20 20 20 20 20 20 20 20 20 4 4 4 4 
4 4 4 4 4 4 4 20 5 5 5 5 5 5 5 5 5 5 5 5 5 5 5 5 5 5 5 5 5 5 5 5 5 5 5 5 5 5 5 5 5 5 5 5 5 5 5 5 5 5 5 5 5 5 5 5 5 5 5 5 6 5 5 5 39 39 39 39 39 39 39 39 5 5 5 5 5 5 5 5 5 5 5 20 20 20 20 20 20 20 20 20 20 20 20 20 4 4 4 4 
4 4 4 4 4 4 4 20 5 5 5 5 5 5 5 5 5 5 5 5 5 5 5 5 5 5 5 6 6 6 6 6 6 6 6 5 6 6 6 6 5 6 6 6 6 6 5 5 5 5 5 5 5 5 5 5 5 5 5 5 5 6 5 5 39 39 39 39 39 39 39 39 5 5 5 5 5 5 5 5 5 5 5 20 20 20 20 20 20 20 20 20 20 20 69 20 4 4 4 4 
4 4 4 4 4 4 4 20 5 5 5 5 5 5 5 5 5 5 5 5 5 5 5 5 6 6 6 6 5 5 5 5 5 5 5 5 5 5 5 5 5 5 5 5 5 5 5 5 5 5 5 5 5 5 5 5 5 5 5 5 5 6 5 5 39 39 39 39 39 39 39 39 5 5 5 5 5 5 5 5 5 5 5 20 20 20 20 20 20 20 20 20 20 5 5 20 4 4 4 4 
4 4 4 4 4 4 4 20 5 5 5 5 5 5 5 5 5 5 5 5 5 6 6 6 5 5 5 5 5 5 5 5 5 5 5 5 5 5 5 5 5 5 5 5 5 5 5 5 5 5 5 5 5 5 5 5 5 5 5 5 5 6 5 5 39 39 39 39 39 39 39 5 5 5 5 5 5 5 5 5 5 5 5 20 20 20 20 20 20 20 20 20 20 5 5 20 4 4 4 4 
4 4 4 4 4 4 4 20 20 5 5 5 5 5 5 5 5 5 6 6 6 5 5 5 5 5 5 5 5 5 5 5 5 5 5 5 5 5 5 5 5 5 5 5 5 5 6 6 5 5 5 5 5 5 5 5 5 5 5 5 5 6 5 5 39 39 39 39 39 39 39 5 5 5 5 5 5 5 5 5 5 5 5 5 5 20 20 20 20 20 20 20 20 5 5 20 4 4 4 4 
4 4 4 4 4 4 4 20 20 5 5 5 5 5 5 5 5 5 6 5 5 5 5 5 5 5 5 5 5 5 24 25 25 25 26 5 5 5 5 5 5 6 6 5 6 6 5 5 5 5 5 5 5 5 5 5 5 5 5 5 5 5 5 39 39 39 39 39 39 39 39 5 5 5 5 5 5 5 5 5 5 5 5 5 5 5 5 5 20 20 20 20 20 5 5 20 4 4 4 4 
4 4 4 4 4 4 4 20 20 5 5 5 5 5 5 5 5 6 5 5 5 5 5 5 5 5 5 5 5 5 27 21 21 21 28 6 6 6 5 5 5 5 5 5 5 5 5 5 5 5 5 5 5 5 5 5 5 5 5 5 6 5 39 39 39 39 39 39 39 39 5 5 5 5 5 5 5 5 5 5 5 5 5 5 5 5 5 20 20 20 20 20 5 20 20 4 4 4 4 
4 4 4 4 4 4 4 20 20 5 5 5 5 5 5 5 6 6 5 5 5 5 5 5 5 5 5 5 5 5 29 30 30 30 31 6 5 5 5 5 5 5 5 5 5 5 5 5 5 5 5 5 5 5 5 5 5 5 5 5 5 6 5 39 39 39 39 39 39 39 39 5 5 5 5 5 5 5 5 5 5 5 5 5 5 5 5 5 5 20 20 20 20 5 20 20 4 4 4 4 
4 4 4 4 4 4 4 20 20 5 5 5 5 5 5 5 6 5 5 5 5 5 5 5 5 5 5 5 5 5 5 5 5 5 5 5 5 5 5 5 5 5 5 5 5 5 5 5 5 5 5 5 5 5 5 5 5 5 5 5 5 6 5 39 39 39 39 39 39 39 39 5 5 5 5 5 5 5 5 5 5 5 5 5 5 5 5 5 5 20 20 20 20 5 20 20 4 4 4 4 
4 4 4 4 4 4 4 20 20 5 5 5 5 5 5 5 6 5 5 5 5 5 5 6 5 5 5 5 5 5 5 5 5 5 5 5 5 5 5 5 5 5 5 5 5 5 5 5 5 5 5 5 5 5 5 5 5 5 5 5 5 6 5 39 39 39 39 39 39 39 39 5 5 5 5 5 5 5 5 5 5 5 5 5 5 5 5 5 5 20 20 20 20 5 20 20 4 4 4 4 
4 4 4 4 4 4 4 20 20 5 5 5 5 5 5 5 5 5 5 5 5 5 5 6 6 6 6 5 5 5 5 5 5 5 5 5 5 5 5 5 5 5 5 5 5 5 5 5 5 5 5 5 5 5 5 5 5 5 5 5 5 6 5 39 39 39 39 39 39 39 39 5 5 5 5 5 5 5 5 5 5 5 5 5 5 5 5 5 5 20 20 20 20 5 20 20 4 4 4 4 
4 4 4 4 4 4 4 20 20 5 5 5 5 5 5 5 5 5 5 5 5 5 5 5 5 5 5 5 6 5 6 6 5 6 6 6 6 6 5 6 6 6 6 6 6 6 6 6 6 6 6 5 5 5 5 5 5 5 5 5 5 6 5 39 39 39 39 39 39 39 39 5 5 5 5 5 5 6 5 5 5 5 5 5 5 5 5 5 5 20 20 20 20 5 20 20 4 4 4 4 
4 4 4 4 4 4 4 20 20 5 5 5 5 5 5 5 5 5 5 5 5 5 5 5 5 5 5 5 5 5 5 5 5 5 5 5 5 5 5 5 5 5 5 5 5 5 5 5 5 5 5 5 5 5 5 5 5 5 5 5 5 6 5 5 39 39 39 39 39 39 39 5 5 5 5 5 5 6 5 5 5 5 5 5 6 5 5 5 5 5 20 20 20 5 20 20 4 4 4 4 
4 4 4 4 4 4 4 20 20 5 5 5 5 5 5 5 5 5 5 5 5 5 5 5 5 5 5 5 5 5 5 5 5 5 5 5 5 5 5 5 5 5 5 5 5 5 5 5 5 5 5 5 5 5 5 5 5 5 5 5 5 6 5 5 39 39 39 39 39 39 39 5 5 5 5 5 5 5 6 5 5 5 5 5 5 6 5 5 5 5 5 5 5 5 20 20 4 4 4 4 
4 4 4 4 4 4 4 20 20 20 20 20 20 20 20 20 20 20 20 20 20 20 20 20 20 20 5 5 5 5 5 5 5 5 5 5 5 5 5 5 5 5 5 5 5 5 5 5 5 5 5 5 5 5 5 5 5 5 5 5 5 6 5 5 39 39 39 39 39 39 39 5 5 5 5 5 5 5 6 5 5 5 5 5 5 6 5 5 5 5 5 5 5 5 20 20 4 4 4 4 
4 4 4 4 4 4 4 20 5 20 20 20 20 20 20 20 20 20 20 20 20 20 20 20 20 20 20 5 5 5 5 5 5 5 6 6 6 6 5 6 5 6 5 5 6 6 5 6 6 5 6 6 5 6 6 6 5 5 5 5 5 6 5 5 39 39 39 39 39 39 39 39 5 5 5 5 5 5 6 5 5 5 5 5 5 6 6 5 5 5 5 5 5 5 20 20 4 4 4 4 
4 4 4 4 4 4 4 46 46 46 46 46 46 67 46 46 46 46 46 46 46 46 46 46 46 20 20 20 5 5 5 5 5 5 5 5 5 5 5 5 5 5 5 5 5 5 5 5 5 5 5 5 5 5 5 5 5 5 5 5 5 6 5 5 39 39 39 39 39 39 39 39 5 5 5 5 5 5 6 5 5 5 5 5 5 5 6 5 5 5 5 5 5 5 20 20 4 4 4 4 
4 4 4 4 4 4 4 46 46 46 46 46 46 46 46 46 46 46 46 46 46 46 46 46 46 20 20 20 20 5 5 5 5 5 5 5 5 5 5 5 5 5 5 5 5 5 5 5 5 5 5 5 5 5 5 5 5 5 5 5 5 6 5 5 5 39 39 39 39 39 39 39 5 5 5 5 5 5 6 5 5 5 6 5 5 5 6 5 5 5 5 5 5 5 20 20 4 4 4 4 
4 4 4 4 4 4 4 46 46 46 46 46 46 46 46 46 46 46 46 46 46 46 46 46 46 46 20 20 20 20 20 5 5 5 5 5 5 5 6 6 6 5 6 5 5 6 6 5 5 6 5 6 6 6 6 6 6 6 6 6 5 6 5 5 5 39 39 39 39 39 39 39 5 5 5 5 5 5 6 5 5 5 6 5 5 5 6 6 5 5 5 5 5 5 20 20 4 4 4 4 
4 4 4 4 4 4 4 46 46 46 46 46 46 46 46 46 46 46 46 46 46 46 46 46 46 46 46 20 20 5 20 5 5 5 5 5 5 5 5 5 5 5 5 5 5 5 5 5 5 5 5 5 5 5 5 5 5 5 5 5 5 6 5 5 5 39 39 39 39 39 39 39 39 5 5 5 5 5 6 5 5 5 6 5 5 5 5 6 5 5 5 5 5 5 20 20 4 4 4 4 
4 4 4 4 4 4 4 46 46 46 46 46 46 46 46 46 46 46 46 46 46 46 46 46 46 46 46 46 20 20 20 20 20 20 20 20 20 20 20 20 20 20 20 20 20 5 5 5 5 5 5 5 5 5 5 5 5 5 5 5 5 6 5 5 5 5 39 39 39 39 39 39 39 5 5 5 5 5 5 6 5 5 5 6 5 5 5 6 6 5 5 5 5 5 20 20 4 4 4 4 
4 4 4 4 4 4 46 46 46 46 46 46 46 46 46 46 46 46 46 46 46 46 46 46 46 46 46 46 46 20 20 20 20 20 20 20 20 20 20 20 20 20 20 20 20 20 20 5 5 5 5 5 5 5 5 5 5 5 5 5 5 6 5 5 5 5 5 39 39 39 39 39 39 5 5 5 5 5 5 6 5 5 5 6 5 5 5 5 5 5 5 5 5 5 20 20 4 4 4 4 
4 4 4 4 4 4 4 46 46 46 46 46 46 46 46 46 46 46 46 46 46 46 46 46 46 46 46 46 46 46 46 46 46 46 46 46 46 46 46 46 46 46 46 46 20 20 20 20 5 5 5 5 5 5 5 5 5 5 5 5 5 6 5 5 5 5 5 5 39 39 39 39 39 5 5 5 5 5 5 5 6 5 5 5 6 5 5 5 6 5 5 5 5 5 20 20 4 4 4 4 
36 36 36 36 36 36 36 36 36 36 36 36 36 36 46 46 46 46 46 46 46 46 46 46 46 46 46 46 46 46 46 46 46 46 46 46 46 46 46 46 46 46 46 46 46 20 20 20 5 5 5 5 5 5 5 5 5 5 5 5 5 6 5 5 5 5 5 5 39 39 39 39 39 5 5 5 5 5 5 5 5 6 5 5 5 5 5 5 6 6 5 5 5 5 20 20 4 4 4 4 
36 36 36 36 36 36 36 36 36 36 36 36 36 36 36 36 36 36 46 46 46 46 46 46 46 46 46 46 46 46 46 46 46 46 46 46 46 46 46 46 46 46 46 46 46 46 20 5 20 5 5 5 5 5 5 5 5 5 5 5 5 6 5 5 5 5 5 5 39 39 39 39 39 39 5 5 5 5 5 5 5 6 5 5 5 6 5 5 5 5 5 5 5 5 20 20 4 4 4 4 
36 36 36 36 36 36 36 36 36 36 36 36 36 36 36 36 36 36 36 36 46 46 46 46 46 46 46 46 46 46 46 46 46 46 46 46 46 46 46 46 46 46 46 46 46 46 20 20 20 5 5 5 5 5 5 5 5 5 5 5 5 6 5 5 5 5 5 5 5 39 39 39 39 39 5 5 5 5 5 5 5 5 6 6 5 5 6 5 5 6 5 5 5 5 20 20 4 4 4 4 
36 36 36 36 36 36 36 36 36 36 36 36 36 36 36 36 36 36 36 36 36 36 46 46 46 46 46 46 46 46 46 46 46 46 46 46 46 46 46 46 46 46 46 46 46 46 46 20 20 5 5 5 5 5 5 5 5 5 5 5 5 6 5 5 5 5 5 5 5 5 39 39 39 39 39 5 5 5 5 5 5 5 5 5 6 5 6 5 5 5 6 5 5 5 5 5 4 4 4 4 
36 36 36 36 36 36 36 36 36 36 36 36 36 36 36 36 36 36 36 36 36 36 36 46 46 46 46 46 46 46 46 46 46 46 46 46 46 46 46 46 46 46 46 46 46 46 46 20 20 5 5 5 5 5 5 5 5 5 5 5 5 6 5 5 5 5 5 5 5 5 5 39 39 39 39 39 5 5 5 5 5 5 5 5 5 6 6 5 5 5 5 5 5 5 5 5 4 4 4 4 
36 36 36 36 36 36 36 36 36 36 36 36 36 36 36 36 36 36 36 36 36 36 36 36 36 46 46 46 46 46 46 46 46 46 46 46 46 46 46 46 46 46 46 46 46 46 46 20 20 20 5 5 5 5 5 5 5 5 5 5 5 5 5 5 5 5 5 5 5 5 5 5 39 39 39 39 39 39 5 5 5 5 5 5 5 5 6 6 5 5 5 6 5 5 5 5 4 4 4 4 
36 36 36 36 36 36 36 36 36 36 36 36 36 36 36 36 36 36 36 36 36 36 36 36 36 36 36 36 36 36 36 36 36 36 36 36 46 46 46 46 46 46 46 46 46 46 46 20 20 20 5 5 5 5 5 5 5 5 5 5 5 5 5 5 5 5 5 5 5 5 5 5 5 39 39 39 39 39 39 39 5 5 5 5 5 5 5 5 6 5 5 6 5 5 5 5 4 4 4 4 
36 36 36 36 36 36 36 36 36 36 36 36 5 5 5 36 36 36 36 36 36 36 36 36 36 36 36 36 36 36 36 36 36 36 36 36 36 36 46 46 46 46 46 46 46 46 46 20 20 20 5 5 5 5 5 5 6 5 5 5 5 5 5 5 5 5 5 5 6 6 5 5 5 5 5 39 39 39 39 39 39 5 5 5 5 5 5 5 5 6 5 6 6 5 5 5 4 4 4 4 
36 36 36 36 36 36 36 36 36 36 36 5 5 5 5 5 36 36 36 36 36 36 36 36 36 5 5 5 5 36 36 36 36 36 36 36 36 36 46 46 46 46 46 46 46 46 46 20 20 20 5 5 5 5 5 5 6 5 5 5 5 5 5 5 5 5 5 5 5 5 6 6 5 5 5 5 39 39 39 39 39 39 5 5 5 5 5 5 5 6 5 5 6 5 5 5 4 4 4 4 
36 36 36 36 36 36 36 36 36 36 5 5 5 5 5 5 5 36 36 36 36 36 36 36 5 5 5 5 5 5 36 36 36 36 36 36 36 36 46 46 46 46 46 46 46 46 46 20 20 20 5 5 5 5 5 5 5 6 5 5 5 5 5 5 5 5 5 5 5 5 5 5 6 5 5 5 5 5 39 39 39 39 39 5 5 5 5 5 5 5 6 5 5 5 5 5 4 4 4 4 
36 36 36 36 36 36 36 36 36 36 5 5 5 5 5 5 5 36 36 36 36 36 36 36 5 5 5 5 5 5 36 36 36 36 36 36 36 36 46 46 46 46 46 46 46 46 46 20 20 20 5 5 5 5 5 5 5 6 6 5 5 5 5 5 5 5 5 5 5 5 5 5 5 6 6 5 5 5 5 39 39 39 39 39 39 5 5 5 5 5 5 5 5 5 5 5 4 4 4 4 
36 36 36 36 36 36 36 36 36 36 69 5 5 5 5 5 5 36 36 36 36 36 36 36 5 5 5 5 5 5 36 36 36 36 36 36 36 36 46 46 46 46 46 46 46 46 46 20 20 20 5 5 5 5 5 5 5 5 6 6 6 5 5 5 5 5 5 5 5 5 5 5 5 5 6 6 6 6 5 5 5 39 39 39 39 39 5 5 5 5 5 5 5 5 5 5 4 4 4 4 
36 36 5 5 5 5 5 5 5 5 5 5 5 5 5 5 5 5 5 5 5 5 5 5 5 5 5 5 5 5 5 5 5 5 5 5 5 5 46 46 46 46 46 46 46 46 46 20 20 20 20 5 5 5 5 5 5 5 5 5 5 6 6 6 6 5 5 5 5 5 5 5 5 5 5 5 5 5 6 6 5 5 5 39 39 39 39 5 5 5 5 5 5 5 5 5 4 4 4 4 
36 5 5 5 5 5 5 5 5 5 5 5 5 5 5 5 5 5 5 5 5 5 5 5 5 5 5 5 5 5 5 5 5 5 5 5 5 5 46 46 46 46 46 46 46 46 46 20 20 5 20 20 20 20 20 5 5 5 5 5 5 5 5 5 5 6 6 6 5 5 5 5 5 5 5 5 5 5 5 6 6 6 5 5 39 39 39 39 39 5 5 5 5 5 5 5 4 4 4 4 
36 5 5 5 5 5 5 5 5 5 5 5 5 5 5 5 5 5 5 5 5 5 5 5 5 5 5 5 5 5 5 5 5 5 5 5 5 5 46 46 46 46 46 46 46 46 46 20 20 20 20 20 20 20 20 20 20 20 20 20 20 20 5 5 5 5 5 5 5 6 6 6 5 5 5 5 5 5 5 5 5 6 6 5 5 39 39 39 39 39 39 5 5 5 5 5 4 4 4 4 
36 5 5 5 5 5 5 5 5 5 5 5 5 5 5 5 5 5 5 5 5 5 5 5 5 5 5 5 5 5 5 5 36 36 36 36 36 36 46 46 46 46 46 46 46 46 46 36 36 36 36 36 36 36 36 36 36 36 36 36 36 36 5 5 5 5 5 5 5 5 5 5 6 5 5 5 5 5 5 5 5 5 5 5 5 5 5 5 39 39 39 39 5 5 5 5 4 4 4 4 
36 36 5 5 5 5 5 5 5 5 5 5 5 5 5 5 5 5 5 5 5 5 5 5 5 36 36 36 36 36 36 36 36 36 36 36 36 36 46 46 46 46 46 46 46 46 46 36 36 36 36 36 36 36 36 36 36 36 36 36 36 36 36 5 5 5 5 36 36 36 36 36 5 5 5 5 5 5 5 5 5 5 5 5 5 5 5 5 39 39 39 39 39 5 5 5 4 4 4 4 
36 36 36 36 36 5 5 36 36 5 5 5 5 5 5 5 5 5 5 5 5 5 5 5 36 36 36 36 36 36 36 36 36 36 36 36 36 36 46 46 46 46 46 46 46 46 46 36 36 36 36 36 36 36 36 36 36 36 36 36 36 36 36 5 5 5 5 36 36 36 36 36 5 5 5 5 36 5 5 5 5 5 5 5 5 5 5 5 5 39 39 39 39 5 5 5 4 4 4 4 
4 4 4 4 4 20 5 5 5 5 46 46 46 46 46 46 46 46 46 46 46 46 46 46 46 46 46 46 46 46 46 46 46 46 46 46 46 46 46 46 46 46 46 46 46 46 46 46 46 46 46 46 46 46 46 46 46 46 46 46 46 46 46 46 46 46 46 46 46 46 46 46 46 46 46 46 46 46 46 46 46 46 46 46 46 46 46 46 46 46 39 39 39 39 39 39 4 4 4 4 
4 4 4 4 4 20 20 5 5 5 46 46 46 46 46 46 46 46 46 46 46 46 46 46 46 46 46 46 46 46 46 46 46 46 46 46 46 46 46 46 46 46 46 46 46 46 46 46 46 46 46 46 46 46 46 46 46 46 46 46 46 46 46 46 46 46 46 46 46 46 46 46 46 46 46 46 46 46 46 46 46 46 46 46 46 46 46 46 46 46 39 39 39 39 39 39 4 4 4 4 
4 4 4 4 4 20 20 5 5 5 46 46 46 46 46 46 46 46 46 46 46 46 46 46 46 46 46 46 46 46 46 46 46 46 46 46 46 46 46 46 46 46 46 46 46 46 46 46 46 46 46 46 46 46 46 46 46 46 46 46 46 46 46 46 46 46 46 46 46 46 46 46 46 46 46 46 46 46 46 46 46 46 46 46 46 46 46 46 46 46 46 39 39 39 39 39 4 4 4 4 
4 4 4 4 4 20 20 20 5 5 46 46 46 46 46 46 46 46 46 46 46 46 46 46 46 46 46 46 46 46 46 46 46 46 46 46 46 46 46 46 46 46 46 46 46 46 46 46 46 46 46 46 46 46 46 46 46 46 46 46 46 46 46 46 46 46 46 46 46 46 46 46 46 46 46 46 46 46 46 46 46 46 46 46 46 46 46 46 46 46 46 46 39 39 39 39 4 4 4 4 
4 4 4 4 4 20 20 20 5 5 46 46 46 46 46 5 5 5 5 5 5 5 5 5 5 5 5 5 5 5 6 6 6 6 6 6 6 6 6 6 6 6 6 6 6 6 6 6 6 6 6 6 6 6 6 6 6 6 6 6 5 5 5 5 5 5 5 5 5 5 5 5 5 5 5 5 5 5 5 5 5 5 5 5 5 5 5 5 5 5 5 5 39 39 39 39 4 4 4 4 
4 4 4 4 4 20 20 20 5 5 46 46 46 46 46 5 5 5 5 5 5 5 5 5 5 5 5 5 5 6 6 5 5 5 5 5 5 5 5 5 5 5 5 5 5 5 5 5 5 5 5 5 5 5 5 5 5 5 5 5 5 6 6 6 6 6 6 6 6 6 6 6 6 6 6 6 6 6 6 6 6 6 6 6 6 5 5 5 5 5 5 5 39 39 39 39 4 4 4 4 
4 4 4 4 4 20 20 20 5 5 46 46 46 46 46 5 5 5 20 20 5 5 5 5 5 5 5 5 5 6 5 5 5 5 6 6 6 6 6 6 6 5 6 6 5 6 6 5 6 6 5 6 6 6 6 6 5 5 5 5 6 5 5 5 5 5 5 5 5 5 5 5 5 5 5 5 5 5 5 5 5 5 5 5 6 6 5 6 6 6 5 5 5 39 39 39 4 4 4 4 
4 4 4 4 4 20 20 20 5 5 46 46 46 46 46 5 5 5 5 20 5 5 5 5 5 5 5 5 5 6 5 5 5 6 6 5 5 5 5 5 5 5 5 5 5 5 5 5 5 5 5 5 6 6 6 6 5 5 5 5 6 5 5 5 5 5 5 5 5 5 5 5 5 5 5 5 5 5 5 5 5 5 5 5 5 6 5 6 5 6 6 5 5 39 39 39 4 4 4 4 
4 4 4 4 4 20 20 5 5 5 46 46 46 46 46 5 5 5 5 20 20 5 5 5 5 5 5 5 5 6 6 6 5 5 6 5 5 5 5 5 5 5 5 5 5 6 6 6 6 6 6 6 5 5 5 5 6 6 6 5 6 5 5 5 5 5 5 5 5 5 5 5 5 5 5 5 5 5 5 5 5 5 5 5 6 6 5 6 5 5 6 6 6 5 39 39 4 4 4 4 
4 4 4 4 4 20 20 5 5 5 46 46 46 46 46 5 5 5 5 20 20 20 5 5 5 5 5 5 5 5 5 6 6 6 6 6 6 6 6 6 6 6 6 6 6 6 5 5 5 5 5 6 6 6 6 6 6 5 6 5 6 5 5 5 5 5 5 5 5 5 5 5 5 5 5 5 5 5 5 5 5 5 5 5 6 5 5 6 5 5 5 5 6 6 5 39 4 4 4 4 
4 4 4 4 4 20 20 5 5 5 46 46 46 46 46 5 5 5 5 20 20 20 5 5 5 5 5 5 5 5 5 5 5 5 5 6 6 6 5 5 5 5 5 5 5 5 5 5 5 6 6 6 5 5 5 5 5 5 6 5 6 5 5 5 5 5 5 5 5 5 5 5 5 5 5 5 5 5 5 5 5 5 6 6 6 5 5 6 6 6 5 5 5 6 6 5 4 4 4 4 
4 4 4 4 4 20 20 5 5 5 46 46 46 46 46 5 5 5 5 5 5 5 5 5 5 5 5 5 5 20 20 20 20 5 5 6 6 6 5 5 5 5 5 5 5 5 5 5 6 6 5 5 5 5 5 5 5 5 6 5 6 5 5 5 5 5 5 5 5 6 6 6 6 6 5 5 5 5 5 5 5 5 5 5 6 5 5 5 5 6 6 5 5 5 5 5 4 4 4 4 
4 4 4 4 4 20 20 5 5 5 46 46 46 46 46 5 5 5 5 5 5 6 6 5 5 5 5 5 20 20 20 20 20 20 5 6 6 5 5 5 20 5 5 5 5 5 5 5 6 5 5 5 5 5 5 5 5 5 6 5 6 5 5 5 5 5 6 6 6 6 5 5 5 5 5 5 5 5 5 5 5 5 5 5 6 5 5 5 5 5 5 6 6 5 5 6 4 4 4 4 
4 4 4 4 4 20 20 5 5 5 46 46 46 46 46 5 5 5 5 5 6 6 5 5 5 5 5 20 20 20 20 20 20 20 5 6 6 5 5 20 20 5 5 5 5 5 5 5 6 5 5 5 5 5 5 5 5 5 6 5 6 5 5 5 5 6 6 6 5 5 5 5 5 5 5 5 5 5 5 5 5 5 5 5 6 5 5 5 6 6 6 6 6 6 6 6 4 4 4 4 
4 4 4 4 4 20 20 20 5 5 46 46 46 46 46 5 5 5 6 6 5 5 5 5 5 5 5 20 20 20 20 20 20 5 5 6 6 6 5 20 20 20 5 5 5 5 5 5 6 5 5 5 20 20 5 5 5 5 6 5 6 5 5 6 6 6 5 5 5 5 5 5 5 5 5 5 5 5 5 5 5 5 5 5 6 5 5 6 5 5 6 6 6 6 5 6 4 4 4 4 
4 4 4 4 4 20 20 20 20 5 46 46 46 46 46 5 5 5 6 5 5 5 5 5 5 5 5 5 5 5 5 5 5 5 6 6 5 6 5 5 5 5 5 5 5 5 5 5 6 5 5 20 20 20 5 5 5 5 6 5 6 6 6 5 5 6 6 6 6 6 5 5 5 5 5 5 5 6 6 6 6 5 5 5 6 5 5 6 6 6 6 5 5 5 5 6 4 4 4 4 
4 4 4 4 4 20 20 20 20 5 46 46 46 46 46 5 5 6 5 5 5 5 5 5 5 5 5 5 5 5 5 5 5 6 6 5 5 5 5 5 5 5 5 5 5 5 5 5 6 5 5 20 20 20 5 5 5 5 6 6 6 5 5 5 5 5 5 5 5 5 5 5 5 5 5 5 5 6 5 5 5 6 5 5 6 5 5 6 5 5 5 5 5 5 5 6 4 4 4 4 
4 4 4 4 4 20 20 20 20 5 46 46 46 46 46 5 5 6 5 5 5 20 5 5 5 5 5 5 5 5 5 6 6 6 5 5 5 5 5 5 5 5 5 5 5 5 5 5 6 5 5 5 20 20 5 5 5 5 6 6 6 5 5 5 5 5 5 5 5 5 5 5 5 5 5 5 6 6 6 6 6 6 5 5 6 5 5 6 5 5 20 20 20 5 5 6 4 4 4 4 
4 4 4 4 4 20 20 20 20 5 46 46 46 46 46 5 5 6 5 5 5 20 20 5 5 5 5 5 5 5 5 5 5 5 5 5 5 6 6 6 6 6 6 6 5 5 5 5 5 5 5 5 20 5 5 5 5 5 5 6 5 5 5 5 5 5 5 5 5 6 6 6 6 6 6 6 6 6 6 5 5 5 5 5 6 5 6 6 5 5 20 20 20 20 5 6 4 4 4 4 
4 4 4 4 4 20 20 20 20 5 46 46 46 46 46 5 5 6 5 20 20 20 20 5 5 5 5 5 5 5 5 5 5 5 5 5 5 5 5 5 5 5 5 5 5 5 5 5 5 5 5 5 5 5 5 5 5 5 6 5 5 5 5 5 6 6 6 6 6 6 5 5 5 5 5 5 6 5 5 5 5 5 5 5 6 5 6 5 5 20 20 20 20 20 5 6 4 4 4 4 
4 4 4 4 4 20 20 20 20 5 46 46 46 46 46 5 5 6 5 20 20 20 20 5 5 5 5 5 5 5 5 5 5 5 5 5 5 5 5 5 5 5 5 5 5 5 5 5 5 5 5 5 5 5 5 5 5 6 6 5 5 5 5 5 6 5 5 5 5 5 5 5 5 5 5 5 6 5 5 5 5 5 5 5 6 5 5 5 5 20 20 20 20 20 20 5 4 4 4 4 
4 4 4 4 4 20 20 20 20 5 46 46 46 46 46 5 6 5 5 5 20 20 20 5 5 5 5 5 5 5 5 5 5 5 5 5 5 5 5 5 5 5 5 5 5 5 5 5 5 5 5 5 5 5 5 5 5 6 5 5 5 5 5 5 6 6 6 6 6 6 6 6 6 6 6 6 6 6 6 6 6 6 6 6 6 5 5 5 5 20 20 20 20 20 20 5 4 4 4 4 
4 4 4 4 4 20 20 20 20 5 46 46 46 46 46 5 6 5 5 5 5 5 5 5 5 5 5 5 5 5 5 5 5 5 5 5 5 5 5 5 5 5 5 5 5 5 5 5 5 5 5 5 5 5 5 5 6 5 5 5 5 5 5 5 5 5 5 5 5 5 5 5 5 5 5 6 5 5 5 5 5 5 5 5 5 5 5 5 20 20 20 20 20 20 20 20 4 4 4 4 
4 4 4 4 4 20 20 20 20 5 46 46 46 46 46 5 6 5 5 5 5 5 5 5 5 5 5 5 5 5 5 5 5 5 5 5 5 5 5 5 5 5 5 5 5 5 5 5 5 5 5 5 5 5 6 6 5 5 5 5 5 5 5 5 5 5 5 5 5 5 5 5 5 5 5 6 5 5 5 5 5 5 5 5 5 5 5 5 20 20 20 20 20 20 20 20 4 4 4 4 
4 4 4 4 4 20 20 20 20 5 46 46 46 46 46 5 6 5 5 5 5 5 5 5 5 5 5 5 5 5 5 5 5 5 5 5 5 5 5 5 5 5 5 5 5 5 5 5 5 5 5 5 6 6 5 5 5 5 5 5 5 5 5 5 5 5 5 5 5 5 5 5 5 5 5 6 5 5 5 5 5 5 5 5 5 5 5 20 20 20 20 20 20 20 20 20 4 4 4 4 
4 4 4 4 4 20 20 20 20 5 46 46 46 46 46 5 6 5 5 5 5 5 5 5 5 5 5 5 5 5 5 5 5 5 5 5 5 5 5 5 5 5 5 6 5 6 5 6 5 5 6 5 6 5 5 6 6 5 6 6 6 6 6 5 5 5 5 5 5 5 5 5 5 5 6 5 5 5 5 5 5 5 5 5 5 5 20 20 20 20 20 20 20 20 20 20 4 4 4 4 
4 4 4 4 4 20 20 20 20 5 46 46 46 46 46 5 6 5 5 5 5 5 5 5 5 5 5 5 5 5 5 5 5 5 5 5 6 6 6 6 5 6 5 5 6 5 5 5 6 5 5 5 5 5 5 5 5 5 5 5 5 5 5 5 5 5 5 5 5 5 5 5 5 6 6 5 5 5 5 5 5 5 5 5 20 20 20 20 20 20 20 20 20 20 20 20 4 4 4 4 
4 4 4 4 4 20 20 20 20 5 46 46 46 46 46 5 6 5 5 5 5 5 5 5 5 5 5 5 5 5 5 5 5 5 5 5 5 5 5 5 5 6 5 5 5 5 5 5 5 5 5 5 5 5 5 5 5 5 5 5 5 5 5 5 5 5 5 5 5 5 5 5 6 6 5 5 5 5 5 5 5 5 5 20 20 20 20 20 20 20 20 20 20 20 20 39 4 4 4 4 
4 4 4 4 4 20 20 20 20 5 46 46 46 46 46 5 6 5 5 5 5 5 5 5 5 5 5 5 5 5 5 5 5 5 5 6 5 5 5 5 5 5 5 5 5 5 5 5 5 5 5 5 5 5 5 5 5 5 5 5 5 5 5 5 5 5 5 5 5 5 6 6 5 5 5 5 5 5 5 5 5 5 5 20 20 20 20 20 20 20 20 20 20 39 39 39 4 4 4 4 
4 4 4 4 4 20 20 20 20 5 46 46 46 46 46 5 6 5 5 5 5 5 5 5 5 5 5 5 6 5 5 6 5 5 5 5 5 5 5 5 5 5 5 5 5 5 5 5 5 5 5 5 5 5 5 5 5 5 5 5 5 5 5 5 5 5 5 5 5 6 5 5 5 5 5 5 5 5 5 5 5 5 5 20 20 20 20 20 20 20 20 39 39 39 39 39 4 4 4 4 
4 4 4 4 4 20 20 20 20 5 46 46 46 46 46 5 6 6 5 5 5 5 5 5 6 6 5 6 5 5 5 5 5 5 5 5 5 5 5 5 5 5 5 5 5 5 5 5 5 5 5 5 5 5 5 5 5 5 5 5 5 5 5 5 5 5 5 5 6 5 5 5 5 5 5 5 5 5 5 5 5 5 5 20 20 20 20 20 20 20 39 39 39 39 39 39 4 4 4 4 
4 4 4 4 4 20 20 20 20 5 46 46 46 46 46 5 5 6 5 5 5 5 5 5 5 5 5 5 5 5 5 5 5 5 5 5 5 5 5 5 5 5 5 5 5 5 5 5 5 5 5 5 5 5 5 5 5 5 5 5 5 5 5 5 5 5 6 5 5 5 5 5 5 5 5 5 5 5 5 5 5 5 5 20 20 20 20 20 20 39 39 39 39 39 39 39 4 4 4 4 
4 4 4 4 4 20 20 20 20 5 46 46 46 46 46 5 5 6 5 5 5 5 5 5 5 5 5 5 5 5 5 5 5 5 5 5 5 5 5 5 5 5 5 5 5 5 5 5 5 5 5 5 5 5 5 5 5 5 5 5 5 5 5 5 5 6 5 5 5 5 5 5 5 5 5 5 5 5 5 5 5 5 5 20 20 20 20 20 39 39 39 39 39 39 39 39 4 4 4 4 
4 4 4 4 4 20 20 20 20 5 46 46 46 46 46 5 5 6 5 5 5 5 5 5 5 5 5 5 5 5 5 5 5 5 5 5 5 5 5 5 5 5 5 5 5 5 5 5 5 5 5 5 5 5 5 5 5 5 5 5 5 5 5 5 6 5 5 5 5 5 5 5 5 5 5 5 5 5 5 5 5 5 5 20 20 20 20 20 39 39 39 39 39 39 39 20 4 4 4 4 
4 4 4 4 4 20 20 20 20 5 46 46 46 46 46 5 5 6 5 5 5 5 5 5 5 5 5 5 5 5 5 5 5 5 5 5 5 5 5 6 5 6 5 5 5 5 5 5 6 5 6 5 5 6 5 5 6 6 6 5 6 5 6 5 5 5 5 5 5 5 5 5 5 5 5 5 5 5 5 5 5 5 5 20 20 20 20 39 39 39 39 39 39 39 39 20 4 4 4 4 
4 4 4 4 4 20 20 20 20 5 46 46 46 46 46 5 5 6 5 6 6 6 6 5 5 6 5 5 6 5 6 5 6 5 6 5 5 5 6 5 5 5 6 5 5 5 6 6 5 5 6 6 6 5 6 6 6 6 6 6 6 5 5 5 5 5 5 5 5 5 5 5 5 5 5 5 5 5 5 5 5 5 5 20 20 20 20 39 39 39 39 39 39 39 20 20 4 4 4 4 
4 4 4 4 4 20 20 20 20 5 46 46 46 46 46 5 5 6 5 5 5 5 5 5 5 6 6 6 6 5 5 5 5 5 5 5 5 5 5 5 5 5 5 5 5 5 5 5 5 5 5 5 5 5 5 6 6 6 5 5 5 5 5 5 5 5 5 5 5 5 5 5 5 5 5 5 5 5 5 5 5 5 5 20 20 20 39 39 39 39 39 39 5 20 20 20 4 4 4 4 
4 4 4 4 4 20 20 20 20 5 46 46 46 46 46 5 5 6 5 5 5 5 5 5 5 5 5 5 5 5 5 5 5 5 5 5 5 5 5 5 5 5 5 5 5 5 5 5 5 5 5 5 6 5 6 5 5 5 5 5 5 5 5 5 5 5 5 5 5 5 5 5 5 5 5 5 5 5 5 5 5 5 20 20 20 39 39 39 39 39 39 39 5 20 20 20 4 4 4 4 
4 4 4 4 4 20 20 20 20 5 46 46 46 46 46 5 5 6 5 5 5 5 5 5 5 5 5 5 5 5 5 5 5 5 5 5 5 5 5 5 5 5 5 5 5 6 6 6 6 6 6 6 5 6 6 6 6 6 6 6 5 5 5 5 5 5 5 5 5 5 5 5 5 5 5 5 5 5 5 5 5 20 20 20 20 39 39 39 39 39 39 5 5 20 20 20 4 4 4 4 
4 4 4 4 4 20 20 20 20 5 46 46 46 46 46 5 5 6 5 5 5 5 5 5 5 5 5 5 5 5 5 5 5 5 5 5 5 5 5 5 5 5 6 6 6 5 6 5 5 5 5 5 5 5 5 5 5 5 5 5 5 5 5 5 5 5 5 5 5 5 5 5 5 5 5 5 5 5 5 5 20 20 20 20 39 39 39 39 39 5 5 5 5 20 20 20 4 4 4 4 
4 4 4 4 4 20 20 20 20 5 46 46 46 46 46 5 5 6 5 5 5 5 5 5 5 5 5 5 5 5 5 5 5 5 5 5 5 5 6 6 6 6 5 5 5 5 5 5 5 5 5 5 5 5 5 5 5 5 5 5 5 5 5 5 5 5 5 5 5 5 5 5 5 5 5 5 5 5 5 20 20 20 20 20 39 39 39 39 39 5 5 5 5 20 20 20 4 4 4 4 
4 4 4 4 4 20 20 20 20 5 46 46 46 46 46 5 5 5 5 5 5 5 5 5 5 5 5 5 5 5 5 5 5 5 5 5 6 6 6 6 5 5 5 5 5 5 5 5 5 5 5 5 5 5 5 5 5 5 5 5 5 5 5 5 5 5 5 5 5 5 5 5 5 5 5 5 5 20 20 20 20 20 20 39 39 39 39 39 5 5 5 5 5 20 20 20 4 4 4 4 
4 4 4 4 4 20 20 20 20 5 46 46 46 46 46 5 5 5 5 5 5 5 5 5 5 5 5 5 5 5 5 5 6 5 6 6 5 5 5 5 5 5 5 5 5 5 5 5 5 5 5 5 5 5 5 5 5 5 5 5 5 5 5 5 5 5 5 5 5 5 5 5 5 5 5 20 20 20 20 20 20 20 39 39 39 39 39 39 5 5 5 5 5 5 5 20 4 4 4 4 
4 4 4 4 4 20 20 20 20 5 46 46 46 46 46 5 5 5 5 5 5 5 6 6 6 6 6 5 6 6 6 5 5 5 5 5 5 5 5 5 5 6 6 6 6 5 6 5 6 5 5 6 6 5 5 6 6 5 6 5 6 6 6 6 6 6 5 5 5 5 5 5 5 20 20 20 20 20 20 20 20 39 39 39 39 39 39 5 5 5 5 5 5 5 5 20 4 4 4 4 
4 4 4 4 4 20 20 20 20 5 46 46 46 46 46 5 5 6 6 6 6 6 5 5 5 5 5 5 5 5 5 5 5 5 5 5 5 5 5 5 5 5 5 5 5 5 5 5 5 5 5 5 5 5 5 5 5 5 5 5 5 5 5 5 5 5 5 5 5 5 5 5 20 20 20 20 20 20 20 20 39 39 39 39 39 39 39 5 20 20 20 20 20 20 20 20 4 4 4 4 
4 4 4 4 4 4 4 4 4 4 4 4 4 4 4 4 4 4 4 4 4 4 4 4 4 4 4 4 4 4 4 4 4 4 4 4 4 4 4 4 4 4 4 4 4 4 4 4 4 4 4 4 4 4 4 4 4 4 4 4 4 4 4 4 4 4 4 4 4 4 4 4 4 4 4 4 4 4 4 4 4 4 4 4 4 4 4 4 4 4 4 4 4 4 4 4 4 4 4 4 
4 4 4 4 4 4 4 4 4 4 4 4 4 4 4 4 4 4 4 4 4 4 4 4 4 4 4 4 4 4 4 4 4 4 4 4 4 4 4 4 4 4 4 4 4 4 4 4 4 4 4 4 4 4 4 4 4 4 4 4 4 4 4 4 4 4 4 4 4 4 4 4 4 4 4 4 4 4 4 4 4 4 4 4 4 4 4 4 4 4 4 4 4 4 4 4 4 4 4 4 
4 4 4 4 4 4 4 4 4 4 4 4 4 4 4 4 4 4 4 4 4 4 4 4 4 4 4 4 4 4 4 4 4 4 4 4 4 4 4 4 4 4 4 4 4 4 4 4 4 4 4 4 4 4 4 4 4 4 4 4 4 4 4 4 4 4 4 4 4 4 4 4 4 4 4 4 4 4 4 4 4 4 4 4 4 4 4 4 4 4 4 4 4 4 4 4 4 4 4 4 
4 4 4 4 4 4 4 4 4 4 4 4 4 4 4 4 4 4 4 4 4 4 4 4 4 4 4 4 4 4 4 4 4 4 4 4 4 4 4 4 4 4 4 4 4 4 4 4 4 4 4 4 4 4 4 4 4 4 4 4 4 4 4 4 4 4 4 4 4 4 4 4 4 4 4 4 4 4 4 4 4 4 4 4 4 4 4 4 4 4 4 4 4 4 4 4 4 4 4 4 
