56 56 56 56 56 56 56 56 56 56 56 56 56 56 56 56 56 56 56 56 56 56 56 56 56 56 56 56 56 56 56 56 56 56 56 56 56 56 56 56 56 56 56 56 56 56 56 56 56 56 
56 56 56 56 56 56 56 56 56 57 56 56 56 56 56 56 56 56 56 56 56 56 56 56 56 56 56 56 56 56 56 56 56 56 56 56 56 56 56 56 56 56 56 56 56 56 56 56 56 56 
56 56 56 56 56 56 56 56 56 56 56 56 56 56 56 56 56 56 56 56 56 56 56 56 56 56 56 56 56 56 56 56 56 56 56 56 56 56 56 56 56 56 56 56 56 56 56 56 56 56 
56 56 56 57 56 56 56 56 56 56 56 56 56 56 56 56 56 56 56 56 56 56 56 56 56 56 56 57 56 56 56 56 56 56 56 57 56 56 56 56 56 56 56 56 56 56 56 56 56 56 
56 56 56 56 56 56 57 56 56 56 56 56 56 56 56 56 56 57 56 56 56 56 57 56 56 56 56 56 56 56 56 56 56 56 56 56 56 56 56 56 56 56 56 56 56 56 56 56 56 56 
56 56 56 56 56 56 56 56 56 56 56 56 57 56 56 56 56 56 56 56 56 56 56 56 56 56 56 56 56 57 56 57 56 56 56 56 56 56 56 56 56 56 56 56 56 56 56 56 56 56 
56 56 56 56 56 56 56 56 66 64 64 64 64 64 64 64 67 56 66 64 64 64 64 64 64 64 64 67 56 56 56 66 64 64 64 64 64 64 64 64 64 64 67 56 56 56 56 56 56 56 
56 57 56 56 56 56 56 56 62 52 32 32 32 32 32 52 63 64 65 52 50 50 50 50 50 50 50 63 64 64 64 65 52 50 46 44 44 44 44 44 44 47 61 56 56 57 56 56 56 56 
56 56 56 56 56 56 56 56 62 52 32 17 17 17 32 52 52 52 52 52 50 58 59 59 59 60 50 52 52 52 52 52 52 52 42 55 55 55 55 55 55 41 61 56 56 56 56 56 56 56 
56 56 56 56 56 56 56 56 62 52 32 17 36 17 32 52 52 52 52 52 50 61 56 56 56 62 50 52 52 52 52 52 52 52 42 55 55 55 55 55 55 41 61 56 56 56 56 57 56 56 
56 56 56 56 56 56 56 56 62 52 32 17 17 17 32 52 52 52 52 52 50 61 56 56 56 62 50 52 52 52 52 52 52 52 42 55 55 55 55 55 55 41 61 57 56 56 56 56 56 56 
56 56 57 56 56 56 56 56 62 52 32 17 17 17 32 52 52 52 52 52 50 63 64 64 64 65 50 52 52 52 52 52 52 52 42 55 55 55 55 55 55 41 61 56 56 56 56 56 56 56 
56 56 56 56 56 57 56 56 62 52 32 32 17 32 32 52 52 52 52 52 50 50 46 44 47 50 50 50 50 50 50 50 50 50 48 39 39 40 55 38 39 49 61 56 56 56 56 56 56 56 
56 56 56 56 56 56 56 56 62 52 52 52 50 52 52 52 52 52 52 52 52 52 42 55 41 52 52 52 52 52 52 52 52 52 52 52 52 42 55 41 58 59 69 56 56 56 57 56 56 56 
56 56 56 56 56 56 56 56 68 60 52 52 50 52 52 52 52 52 52 52 52 52 42 55 41 52 52 52 52 52 52 52 52 52 52 52 52 42 55 41 61 56 56 56 56 56 56 56 56 56 
56 57 56 56 56 56 56 57 56 62 52 52 50 52 52 52 52 52 52 52 52 52 42 55 41 52 52 52 52 52 52 52 70 50 50 50 52 42 55 41 61 57 56 56 56 56 56 56 56 56 
56 56 56 56 56 56 56 56 66 65 52 52 50 52 52 52 52 52 52 52 52 52 42 55 41 50 50 50 52 52 52 52 50 50 50 50 52 42 55 41 61 56 56 57 56 56 56 56 56 56 
56 56 56 56 56 56 56 66 65 52 52 52 50 52 52 52 52 52 52 52 52 52 42 55 41 52 52 52 52 52 52 52 52 52 52 50 44 45 55 41 61 56 56 56 56 56 56 56 56 56 
56 56 56 56 56 56 56 62 52 52 50 50 50 52 52 52 52 52 52 52 52 52 42 55 41 52 52 52 52 52 52 52 52 52 52 42 55 55 55 41 61 56 56 56 56 56 57 56 56 56 
56 56 56 56 56 57 56 62 52 52 50 52 52 52 52 52 52 52 52 52 52 50 42 55 41 50 52 52 52 52 52 52 52 52 52 42 55 38 39 49 61 56 56 56 56 56 56 56 56 56 
56 56 56 56 56 56 56 62 52 52 50 52 52 50 46 44 44 44 44 44 44 44 45 55 43 44 44 44 44 47 52 52 52 46 44 45 55 41 50 52 61 56 56 57 56 56 56 56 56 56 
56 56 56 57 56 56 56 62 52 52 50 52 52 50 42 55 55 55 55 55 55 55 55 55 55 55 55 55 55 41 50 50 50 42 55 55 55 41 50 58 69 56 56 56 56 56 56 56 56 56 
56 56 56 56 56 56 56 62 52 52 50 52 52 50 48 39 39 39 39 39 39 39 40 55 38 39 39 39 39 49 52 52 52 48 39 40 55 41 51 61 56 56 57 56 56 56 56 56 56 56
56 56 56 56 56 56 56 68 60 52 50 52 52 50 52 52 52 52 52 52 52 50 42 55 41 50 52 52 52 52 52 52 52 52 52 42 55 41 50 61 56 56 56 56 56 56 56 56 56 56
56 56 56 56 56 56 56 56 62 52 50 52 52 50 52 52 52 52 52 52 52 52 42 55 41 52 52 52 52 52 52 52 52 52 52 42 55 41 50 61 56 56 56 56 56 56 56 56 56 56
56 56 56 56 56 56 56 66 65 52 50 52 52 50 50 52 52 52 52 52 52 52 42 55 41 52 52 52 52 50 50 50 50 50 52 42 55 41 50 61 56 56 56 56 56 56 57 56 56 56 
56 56 56 57 56 56 56 62 52 52 50 52 52 52 50 52 52 52 52 52 52 52 42 55 41 52 52 52 52 50 50 50 50 50 52 42 55 41 50 61 56 56 56 56 56 56 56 56 56 56 
56 56 56 56 56 56 56 62 52 52 50 52 52 52 50 52 52 52 52 52 52 52 42 55 41 50 50 50 52 50 50 50 50 50 52 42 55 41 50 61 56 56 56 56 56 56 56 56 56 56 
56 56 56 56 56 56 56 62 52 52 50 52 52 52 50 52 52 52 52 52 52 52 42 55 41 52 52 50 52 50 50 50 50 50 52 42 55 41 50 61 56 56 57 56 56 56 56 56 56 56 
56 56 57 56 56 56 56 62 52 52 50 50 50 50 50 50 52 52 52 52 52 52 42 55 41 52 52 50 52 52 52 52 50 50 52 48 39 49 50 61 56 56 56 56 56 56 56 56 56 56 
56 56 56 56 56 56 56 62 52 52 50 51 50 50 50 50 52 52 52 52 52 52 42 55 41 52 52 50 50 50 50 50 50 50 52 52 50 52 58 69 56 56 56 56 56 56 56 56 56 56 
56 56 56 56 56 56 57 68 60 52 50 50 50 50 50 50 52 52 52 52 52 52 42 55 41 52 52 50 50 50 50 50 52 52 52 52 50 50 61 56 57 56 56 56 56 56 56 56 56 56 
56 56 56 56 56 56 56 56 62 52 50 50 50 51 50 50 52 52 52 52 52 52 42 55 41 52 52 52 52 52 52 52 52 52 52 50 50 50 61 56 56 56 56 56 56 56 56 57 56 56 
56 56 56 56 56 56 56 56 62 52 50 50 50 50 50 50 52 52 52 52 52 52 42 55 41 52 52 52 52 52 52 52 52 52 52 50 50 51 61 56 56 56 56 56 56 56 56 56 56 56 
56 56 56 56 57 56 56 56 62 52 50 50 50 50 50 50 52 52 52 52 52 52 42 55 41 52 52 52 52 52 52 52 52 52 52 50 50 50 61 56 56 56 56 56 56 56 56 56 56 56 
56 56 56 56 56 56 56 66 65 52 52 52 52 52 52 52 52 52 52 52 52 52 48 39 49 52 52 52 52 52 52 52 52 52 52 50 50 50 63 67 56 56 56 56 56 56 56 56 56 56 
56 56 56 56 56 56 56 62 52 52 52 52 52 52 52 52 52 52 52 52 50 50 50 50 50 50 50 52 52 52 52 52 52 52 50 50 50 50 50 63 67 56 56 57 56 56 56 56 56 56 
56 56 56 56 56 56 56 62 52 52 52 52 52 52 52 52 52 52 52 50 50 50 50 51 50 50 50 50 52 52 50 52 52 50 50 51 50 50 50 50 61 56 56 56 56 56 56 56 56 56 
56 56 56 56 56 56 56 62 52 52 52 52 52 52 52 52 52 52 52 50 50 50 50 50 50 50 50 50 52 52 52 52 50 50 50 50 50 50 50 50 61 56 56 56 56 56 56 56 56 56 
56 56 56 56 56 56 56 62 52 52 50 52 52 52 52 52 52 52 52 50 50 50 50 50 50 50 51 50 50 52 52 52 50 50 50 50 50 52 50 51 61 56 56 56 56 56 56 56 56 56 
56 56 56 56 56 57 56 62 52 52 50 52 52 50 50 50 50 50 50 50 51 50 50 50 50 50 50 50 50 50 50 50 50 50 52 50 50 50 50 50 61 56 56 56 56 56 56 56 56 56 
56 56 56 56 56 56 56 62 52 52 50 50 50 50 52 58 59 59 60 50 50 50 50 70 50 50 50 58 59 59 60 50 50 50 50 50 50 50 50 50 61 56 56 56 56 56 56 56 56 56 
56 57 56 56 56 56 56 62 52 52 52 52 52 52 58 69 56 56 68 60 50 50 50 50 50 50 58 69 56 56 62 50 50 52 50 50 52 50 50 50 61 56 56 56 56 56 57 56 56 56 
56 56 56 56 56 56 56 68 59 59 59 59 59 59 69 56 56 56 56 68 59 59 59 59 59 59 69 56 56 56 68 60 50 50 50 50 50 50 58 59 69 56 57 56 56 56 56 56 56 56 
56 56 56 56 56 56 56 56 56 56 56 56 56 56 57 56 56 56 56 56 56 56 56 56 56 56 56 56 57 56 56 68 59 59 59 59 59 59 69 56 56 56 56 56 56 56 56 56 56 56 
56 56 56 56 57 56 56 56 56 56 56 56 56 56 56 56 56 56 56 56 56 56 56 56 56 56 56 56 56 56 56 56 57 56 56 56 56 56 56 57 56 56 56 56 56 56 56 56 56 56 
56 56 56 56 56 56 56 56 56 57 56 56 56 56 56 56 56 56 56 56 56 56 56 57 56 56 56 56 56 56 56 56 56 56 56 56 56 56 56 56 56 56 56 56 56 57 56 56 56 56 
56 56 56 56 56 56 56 56 56 56 56 56 56 56 56 56 56 56 56 56 56 56 56 56 56 56 56 56 56 56 56 56 56 56 56 56 56 56 56 56 56 56 56 56 56 56 56 56 56 56 
56 56 56 56 56 56 56 56 56 56 56 56 56 56 56 56 56 56 56 56 56 56 56 56 56 56 56 56 56 56 56 56 56 56 56 56 56 56 56 56 56 56 56 56 56 56 56 56 56 56 
56 56 56 56 56 56 56 56 56 56 56 56 56 56 56 56 56 56 56 56 56 56 56 56 56 56 56 56 56 56 56 56 56 56 56 56 56 56 56 56 56 56 56 56 56 56 56 56 56 56 