231 231 231 231 231 231 231 231 231 231 231 231 231 231 231 231 231 231 231 231 231 231 231 231 231 231 231 231 231 231 231 231 231 231 231 231 231 231 231 231 231 231 231 231 231 231 231 231 231 231 
231 231 231 231 231 231 231 231 231 232 231 231 231 231 231 231 231 231 231 231 231 231 231 231 231 231 231 231 231 231 231 231 231 231 231 231 231 231 231 231 231 231 231 231 231 231 231 231 231 231 
231 231 231 231 231 231 231 231 231 231 231 231 231 231 231 231 231 231 231 231 231 231 231 231 231 231 231 231 231 231 231 231 231 231 231 231 231 231 231 231 231 231 231 231 231 231 231 231 231 231 
231 231 231 232 231 231 231 231 231 231 231 231 231 231 231 231 231 231 231 231 231 231 231 231 231 231 231 232 231 231 231 231 231 231 231 232 231 231 231 231 231 231 231 231 231 231 231 231 231 231 
231 231 231 231 231 231 232 231 231 231 231 231 231 231 231 231 231 232 231 231 231 231 232 231 231 231 231 231 231 231 231 231 231 231 231 231 231 231 231 231 231 231 231 231 231 231 231 231 231 231 
231 231 231 231 231 231 231 231 231 231 231 231 232 231 231 231 231 231 231 231 231 231 231 231 231 231 231 231 231 232 231 232 231 231 231 231 231 231 231 231 231 231 231 231 231 231 231 231 231 231 
231 231 231 231 231 231 231 231 241 239 239 239 239 239 239 239 242 231 241 239 239 239 239 239 239 239 239 242 231 231 231 241 239 239 239 239 239 239 239 239 239 239 242 231 231 231 231 231 231 231 
231 232 231 231 231 231 231 231 237 230 32 32 32 32 32 230 238 239 240 230 213 213 213 213 213 213 213 238 239 239 239 240 229 213 224 222 222 222 222 222 222 225 236 231 231 232 231 231 231 231 
231 231 231 231 231 231 231 231 237 230 32 17 17 17 32 230 230 230 230 230 213 233 234 234 234 235 213 229 229 229 229 229 229 229 220 215 215 215 215 215 215 219 236 231 231 231 231 231 231 231 
231 231 231 231 231 231 231 231 237 230 32 17 36 17 32 230 230 230 230 230 213 236 231 231 231 237 213 229 229 229 229 229 229 229 220 215 215 215 215 215 215 219 236 231 231 231 231 232 231 231 
231 231 231 231 231 231 231 231 237 230 32 17 17 17 32 230 230 230 230 230 213 236 231 231 231 237 213 229 229 229 229 229 229 229 220 215 215 215 215 215 215 219 236 232 231 231 231 231 231 231 
231 231 232 231 231 231 231 231 237 230 32 17 17 17 32 230 230 230 230 230 213 238 239 239 239 240 213 229 229 229 229 229 229 229 220 215 215 215 215 215 215 219 236 231 231 231 231 231 231 231 
231 231 231 231 231 232 231 231 237 230 32 32 17 32 32 230 230 230 230 230 213 213 224 222 225 213 213 213 213 213 213 213 213 213 226 217 217 218 215 216 217 227 236 231 231 231 231 231 231 231 
231 231 231 231 231 231 231 231 237 230 230 230 213 230 230 230 230 230 230 230 230 230 220 215 219 229 229 229 229 229 229 229 229 229 229 229 229 220 215 219 233 234 244 231 231 231 232 231 231 231 
231 231 231 231 231 231 231 231 243 235 230 230 213 230 230 230 230 230 230 230 230 230 220 215 219 229 229 229 229 229 229 229 229 229 229 229 229 220 215 219 236 231 231 231 231 231 231 231 231 231 
231 232 231 231 231 231 231 232 231 237 230 230 213 230 230 230 230 230 230 230 230 230 220 215 219 229 229 229 229 229 229 229 229 229 229 229 229 220 215 219 236 232 231 231 231 231 231 231 231 231 
231 231 231 231 231 231 231 231 241 240 230 230 213 230 230 230 230 230 230 230 230 230 220 215 219 213 213 213 229 229 229 229 229 229 229 229 229 220 215 219 236 231 231 232 231 231 231 231 231 231 
231 231 231 231 231 231 231 241 240 230 230 230 213 230 230 230 230 230 230 230 230 230 220 215 219 229 229 229 229 229 229 229 229 229 229 224 222 223 215 219 236 231 231 231 231 231 231 231 231 231 
231 231 231 231 231 231 231 237 230 230 213 213 213 230 230 230 230 230 230 230 230 230 220 215 219 229 229 229 229 229 229 229 229 229 229 220 215 215 215 219 236 231 231 231 231 231 232 231 231 231 
231 231 231 231 231 232 231 237 230 230 213 230 230 230 230 230 230 230 230 230 230 213 220 215 219 213 229 229 229 229 229 229 229 229 229 220 215 216 217 227 236 231 231 231 231 231 231 231 231 231 
231 231 231 231 231 231 231 237 230 230 213 230 230 213 224 222 222 222 222 222 222 222 223 215 221 222 222 222 222 225 229 229 229 224 222 223 215 219 213 229 236 231 231 232 231 231 231 231 231 231 
231 231 231 232 231 231 231 237 230 230 213 230 230 213 220 215 215 215 215 215 215 215 215 215 215 215 215 215 215 219 213 213 213 220 215 215 215 219 213 233 244 231 231 231 231 231 231 231 231 231 
231 231 231 231 231 231 231 237 230 230 213 230 230 213 226 217 217 217 217 217 217 217 218 215 216 217 217 217 217 227 229 229 229 226 217 218 215 219 214 236 231 231 232 231 231 231 231 231 231 231 
231 231 231 231 231 231 231 243 235 230 213 230 230 213 230 230 230 230 230 230 230 213 220 215 219 213 229 229 229 229 229 229 229 229 229 220 215 219 213 236 231 231 231 231 231 231 231 231 231 231 
231 231 231 231 231 231 231 231 237 230 213 230 230 213 230 230 230 230 230 230 230 230 220 215 219 229 229 229 229 229 229 229 229 229 229 220 215 219 213 236 231 231 231 231 231 231 231 231 231 231 
231 231 231 231 231 231 231 241 240 230 213 230 230 213 213 230 230 230 230 230 230 230 220 215 219 229 229 229 229 229 229 229 229 229 229 220 215 219 213 236 231 231 231 231 231 231 232 231 231 231 
231 231 231 232 231 231 231 237 230 230 213 230 230 230 213 230 230 230 230 230 230 230 220 215 219 229 229 229 229 229 229 229 229 229 229 220 215 219 213 236 231 231 231 231 231 231 231 231 231 231 
231 231 231 231 231 231 231 237 230 230 213 230 230 230 213 230 230 230 230 230 230 230 220 215 219 213 213 213 229 229 229 229 229 229 229 220 215 219 213 236 231 231 231 231 231 231 231 231 231 231 
231 231 231 231 231 231 231 237 230 230 213 230 230 230 213 230 230 230 230 230 230 230 220 215 219 229 229 213 229 229 229 229 229 229 229 220 215 219 213 236 231 231 232 231 231 231 231 231 231 231 
231 231 232 231 231 231 231 237 230 230 213 213 213 213 213 213 230 230 230 230 230 230 220 215 219 229 229 213 229 229 213 229 229 229 229 226 217 227 213 236 231 231 231 231 231 231 231 231 231 231 
231 231 231 231 231 231 231 237 230 230 213 214 213 213 213 213 230 230 230 230 230 230 220 215 219 229 229 213 229 229 213 229 229 229 229 229 213 229 233 244 231 231 231 231 231 231 231 231 231 231 
231 231 231 231 231 231 232 243 235 230 213 213 213 213 213 213 230 230 230 230 230 230 220 215 219 229 229 213 213 213 213 229 229 229 229 229 213 213 236 231 232 231 231 231 231 231 231 231 231 231 
231 231 231 231 231 231 231 231 237 230 213 213 213 214 213 213 230 230 230 230 230 230 220 215 219 229 229 229 229 229 229 229 229 229 229 213 213 213 236 231 231 231 231 231 231 231 231 232 231 231 
231 231 231 231 231 231 231 231 237 230 213 213 213 213 213 213 230 230 230 230 230 230 220 215 219 229 229 229 229 229 229 229 229 229 229 213 213 214 236 231 231 231 231 231 231 231 231 231 231 231 
231 231 231 231 232 231 231 231 237 230 213 213 213 213 213 213 230 230 230 230 230 230 220 215 219 229 229 229 229 229 229 229 229 229 229 213 213 213 236 231 231 231 231 231 231 231 231 231 231 231 
231 231 231 231 231 231 231 241 240 230 230 230 230 230 230 230 230 230 230 230 230 230 226 217 227 229 229 229 229 229 229 229 229 229 229 213 213 213 238 242 231 231 231 231 231 231 231 231 231 231 
231 231 231 231 231 231 231 237 230 230 230 230 230 230 230 230 230 230 230 230 213 213 213 213 213 213 213 229 229 229 229 229 229 229 213 213 213 213 213 238 242 231 231 232 231 231 231 231 231 231 
231 231 231 231 231 231 231 237 230 230 230 230 230 230 230 230 230 230 230 213 213 213 213 214 213 213 213 213 229 229 213 229 229 213 213 214 213 213 213 213 236 231 231 231 231 231 231 231 231 231 
231 231 231 231 231 231 231 237 230 230 230 230 230 230 230 230 230 230 230 213 213 213 213 213 213 213 213 213 229 229 229 229 213 213 213 213 213 213 213 213 236 231 231 231 231 231 231 231 231 231 
231 231 231 231 231 231 231 237 230 230 245 230 230 230 230 230 230 230 230 213 213 213 213 245 213 213 214 213 213 229 229 229 213 213 213 213 213 229 213 214 236 231 231 231 231 231 231 231 231 231 
231 231 231 231 231 232 231 237 230 230 213 230 230 213 213 213 213 213 213 213 214 213 213 213 213 213 213 213 213 213 213 213 213 213 229 213 213 213 213 213 236 231 231 231 231 231 231 231 231 231 
231 231 231 231 231 231 231 237 230 230 213 213 213 213 230 233 234 234 235 213 213 213 213 213 213 213 213 233 234 234 235 213 213 213 213 213 213 213 213 213 236 231 231 231 231 231 231 231 231 231 
231 232 231 231 231 231 231 237 230 230 230 230 230 230 233 244 231 231 243 235 213 213 213 213 213 213 233 244 231 231 237 213 213 229 213 213 229 213 213 213 236 231 231 231 231 231 232 231 231 231 
231 231 231 231 231 231 231 243 234 234 234 234 234 234 244 231 231 231 231 243 234 234 234 234 234 234 244 231 231 231 243 235 213 213 213 213 213 213 233 234 244 231 232 231 231 231 231 231 231 231 
231 231 231 231 231 231 231 231 231 231 231 231 231 231 232 231 231 231 231 231 231 231 231 231 231 231 231 231 232 231 231 243 234 234 234 234 234 234 244 231 231 231 231 231 231 231 231 231 231 231 
231 231 231 231 232 231 231 231 231 231 231 231 231 231 231 231 231 231 231 231 231 231 231 231 231 231 231 231 231 231 231 231 232 231 231 231 231 231 231 232 231 231 231 231 231 231 231 231 231 231 
231 231 231 231 231 231 231 231 231 232 231 231 231 231 231 231 231 231 231 231 231 231 231 232 231 231 231 231 231 231 231 231 231 231 231 231 231 231 231 231 231 231 231 231 231 232 231 231 231 231 
231 231 231 231 231 231 231 231 231 231 231 231 231 231 231 231 231 231 231 231 231 231 231 231 231 231 231 231 231 231 231 231 231 231 231 231 231 231 231 231 231 231 231 231 231 231 231 231 231 231 
231 231 231 231 231 231 231 231 231 231 231 231 231 231 231 231 231 231 231 231 231 231 231 231 231 231 231 231 231 231 231 231 231 231 231 231 231 231 231 231 231 231 231 231 231 231 231 231 231 231 
231 231 231 231 231 231 231 231 231 231 231 231 231 231 231 231 231 231 231 231 231 231 231 231 231 231 231 231 231 231 231 231 231 231 231 231 231 231 231 231 231 231 231 231 231 231 231 231 231 231 