0 0 0 0 0 0 0 0 0 0 0 0 0 0 0 0 0 0 0 0 0 0 0 0 0 0 0 0 0 0 0 0 0 0 0 0 0 0 0 0 0 0 0 0 0 0 0 0 0 0 0 0 0 0 0 0 0
0 0 0 0 0 0 0 0 0 0 0 0 0 0 0 0 0 0 0 0 0 0 0 0 0 0 0 0 0 0 0 0 0 0 0 0 0 0 0 0 0 0 0 0 0 0 0 0 0 0 0 0 0 0 0 0 0
0 0 0 0 0 0 0 0 0 0 0 0 0 0 0 0 0 0 0 0 0 0 0 0 0 0 0 0 0 0 0 0 0 0 0 0 0 0 0 0 0 0 0 0 0 0 0 0 0 0 0 0 0 0 0 0 0
0 0 0 0 0 0 0 0 0 0 0 0 0 0 0 0 0 0 0 0 0 0 0 0 0 0 0 0 0 0 0 0 0 0 0 0 0 0 0 0 0 0 0 0 0 0 0 0 0 0 0 0 0 0 0 0 0
0 0 0 0 0 0 0 0 0 0 0 0 0 0 0 0 0 0 0 0 0 0 0 0 0 0 0 0 0 0 0 0 0 0 0 0 0 0 0 0 0 0 0 0 0 0 0 0 0 0 0 0 0 0 0 0 0
0 0 0 0 0 0 0 0 0 0 0 0 0 0 0 0 0 0 0 0 0 0 0 0 0 0 0 0 0 0 0 0 0 0 0 0 0 0 0 0 0 0 0 0 0 0 0 0 0 0 0 0 0 0 0 0 0
0 0 0 0 0 0 0 32 32 32 32 32 32 32 32 32 32 32 32 32 32 32 32 32 32 32 32 32 32 32 32 32 32 32 32 32 32 32 32 32 32 32 32 0 0 0 0 0 0 0 0 0 0 0 0 0 0 
0 0 0 0 0 0 0 32 36 17 32 32 32 32 32 32 32 32 32 32 32 32 32 32 32 32 32 32 32 32 32 32 32 32 32 32 32 32 32 32 32 32 32 0 0 0 0 0 0 0 0 0 0 0 0 0 0 
0 0 0 0 0 0 0 32 17 17 32 32 32 32 32 17 17 17 17 17 17 32 32 32 32 32 32 32 32 32 32 17 17 17 17 17 17 32 32 32 32 32 32 0 0 0 0 0 0 0 0 0 0 0 0 0 0 
0 0 0 0 0 0 0 32 32 17 32 32 32 32 17 17 17 17 17 17 17 17 32 32 32 32 32 32 32 32 17 17 17 17 32 32 17 32 32 32 32 32 32 0 0 0 0 0 0 0 0 0 0 0 0 0 0 
0 0 0 0 0 0 0 32 32 17 17 17 17 17 17 17 17 17 17 17 17 17 32 32 32 32 17 17 17 17 17 17 17 32 32 32 17 17 32 32 32 32 32 0 0 0 0 0 0 0 0 0 0 0 0 0 0 
0 0 0 0 0 0 0 32 32 32 32 32 32 32 17 17 17 17 17 17 17 17 32 32 32 17 17 17 17 17 17 17 32 32 32 32 32 17 32 32 32 32 32 0 0 0 0 0 0 0 0 0 0 0 0 0 0 
0 0 0 0 0 0 0 32 32 32 32 32 32 32 32 17 17 17 17 17 17 32 32 32 17 17 17 17 17 17 32 32 32 32 32 32 32 17 17 32 32 32 32 0 0 0 0 0 0 0 0 0 0 0 0 0 0 
0 0 0 0 0 0 0 32 32 32 32 32 32 32 32 32 32 32 17 32 32 32 32 17 17 17 17 32 32 32 32 32 32 32 32 32 17 17 17 17 32 32 32 0 0 0 0 0 0 0 0 0 0 0 0 0 0 
0 0 0 0 0 0 0 32 32 32 32 32 32 32 32 32 32 32 17 32 32 32 17 17 17 32 32 32 32 32 32 32 32 32 32 17 17 17 17 17 32 32 32 247 247 247 247 247 0 0 0 0 
0 0 0 0 0 0 0 32 32 32 32 32 32 32 32 17 17 17 17 17 32 32 17 17 17 32 32 17 32 32 32 32 32 32 32 17 17 17 17 17 17 17 17 0 0 0 0 0 247 247 0 0 0 0 0 0 0
0 0 0 0 0 0 0 32 32 32 32 32 32 17 17 17 32 17 17 17 32 32 17 32 32 32 32 17 32 32 32 32 32 32 17 17 17 17 17 17 17 32 32 247 247 247 247 247 0 0 0 0 
0 0 0 0 0 0 0 32 17 17 32 32 32 32 32 32 32 32 17 32 32 32 17 32 32 17 17 17 17 17 32 32 17 17 17 32 32 17 17 17 32 32 32 0 0 0 0 0 0 0 0 0 0 0 0 0 0
0 0 0 0 0 0 0 32 17 17 17 17 17 32 32 32 32 32 17 32 32 32 17 32 32 17 17 17 17 17 32 17 17 32 32 32 32 32 17 32 32 32 32 0 0 0 0 0 0 0 0 0 0 0 0 0 0
0 0 0 0 0 0 0 32 17 17 17 17 17 32 32 32 32 32 17 32 32 32 17 32 32 17 17 17 17 17 17 17 32 32 32 32 32 32 17 32 32 32 32 0 0 0 0 0 0 0 0 0 0 0 0 0 0
0 0 0 0 0 0 0 32 17 17 17 17 17 32 32 32 32 32 17 32 32 32 17 32 32 32 17 17 17 17 32 32 32 32 32 32 32 32 17 32 32 32 32 0 0 0 0 0 0 0 0 0 0 0 0 0 0
0 0 0 0 0 0 0 32 17 17 17 17 17 32 32 32 32 32 17 32 32 32 17 17 32 32 32 32 32 32 32 32 32 32 32 32 32 32 17 32 32 32 32 0 0 0 0 0 0 0 0 0 0 0 0 0 0
0 0 0 0 0 0 0 32 32 32 17 32 32 32 32 32 32 32 17 32 17 17 17 17 32 32 32 32 32 32 32 32 32 32 32 32 32 32 17 32 32 32 32 0 0 0 0 0 0 0 0 0 0 0 0 0 0
0 0 0 0 0 0 0 32 32 32 17 32 32 32 32 32 32 32 17 32 32 32 32 32 32 32 32 32 32 32 32 32 32 32 32 32 32 17 17 17 17 32 32 0 0 0 0 0 0 0 0 0 0 0 0 0 0
0 0 0 0 0 0 0 32 32 32 17 32 32 32 17 17 17 17 17 17 17 17 32 32 32 32 32 32 32 32 32 32 32 32 17 17 17 17 17 17 17 32 32 0 0 0 0 0 0 0 0 0 0 0 0 0 0
0 0 0 0 0 0 0 32 32 32 17 32 32 17 17 17 17 17 17 17 17 17 17 32 32 32 32 32 32 32 32 32 17 17 17 17 17 17 17 17 17 32 32 0 0 0 0 0 0 0 0 0 0 0 0 0 0
0 0 0 0 0 0 0 32 32 32 17 17 17 17 17 17 17 17 17 17 17 17 17 32 32 32 32 32 32 32 32 32 17 17 17 17 17 17 17 17 17 32 32 0 0 0 0 0 0 0 0 0 0 0 0 0 0
0 0 0 0 0 0 0 32 32 32 17 17 17 17 17 17 17 17 17 17 17 17 17 32 32 32 32 32 32 32 32 32 17 17 17 17 17 17 17 17 17 32 32 0 0 0 0 0 0 0 0 0 0 0 0 0 0
0 0 0 0 0 0 0 32 32 32 32 32 32 32 17 17 17 17 17 17 17 17 17 17 17 17 17 17 17 17 17 17 17 17 17 17 17 32 32 17 17 32 32 0 0 0 0 0 0 0 0 0 0 0 0 0 0
0 0 0 0 0 0 0 32 32 32 32 32 32 32 32 32 32 17 17 32 32 32 32 32 32 32 17 32 32 32 32 32 17 17 17 32 32 32 32 17 17 32 32 0 0 0 0 0 0 0 0 0 0 0 0 0 0
0 0 0 0 0 0 0 32 32 32 32 32 32 32 32 32 32 17 17 32 32 32 32 32 32 32 17 32 32 32 32 32 32 32 32 32 32 32 17 17 17 32 32 0 0 0 0 0 0 0 0 0 0 0 0 0 0
0 0 0 0 0 0 0 32 32 32 32 32 32 32 32 32 32 17 17 32 32 32 32 32 32 32 17 32 32 32 32 32 32 32 32 32 32 32 32 17 17 32 32 0 0 0 0 0 0 0 0 0 0 0 0 0 0
0 0 0 0 0 0 0 32 32 32 32 32 32 32 32 32 32 17 17 32 32 32 32 32 32 32 17 32 32 32 32 32 32 32 32 32 32 32 32 32 32 32 32 0 0 0 0 0 0 0 0 0 0 0 0 0 0
0 0 0 0 0 0 0 32 32 32 32 32 32 32 32 32 32 17 17 32 32 32 32 32 32 17 17 17 32 32 32 32 32 32 32 32 32 32 32 32 32 32 32 0 0 0 0 0 0 0 0 0 0 0 0 0 0
0 0 0 0 0 0 0 32 32 32 32 32 32 32 32 32 32 17 17 32 32 32 32 32 32 17 17 17 32 32 32 32 32 32 32 32 32 32 32 32 32 32 32 0 0 0 0 0 0 0 0 0 0 0 0 0 0
0 0 0 0 0 0 0 32 32 32 32 32 32 32 32 17 17 17 17 17 17 32 32 32 32 32 32 32 32 32 32 32 32 32 32 32 32 32 32 32 32 32 32 0 0 0 0 0 0 0 0 0 0 0 0 0 0
0 0 0 0 0 0 0 32 32 32 32 32 32 32 32 17 17 17 17 17 17 32 32 32 32 32 32 32 32 32 32 32 32 32 32 32 32 32 32 32 32 32 32 0 0 0 0 0 0 0 0 0 0 0 0 0 0
0 0 0 0 0 0 0 32 32 17 17 17 17 17 17 17 17 17 17 17 17 32 32 32 32 32 32 32 32 32 32 32 32 32 32 32 17 17 17 17 17 32 32 0 0 0 0 0 0 0 0 0 0 0 0 0 0
0 0 0 0 0 0 0 32 32 17 32 32 32 32 32 17 17 17 17 17 17 32 32 32 32 32 32 32 32 32 32 32 17 17 17 17 17 17 32 17 17 32 32 0 0 0 0 0 0 0 0 0 0 0 0 0 0
0 0 0 0 0 0 0 32 32 17 32 32 32 32 32 17 17 17 17 17 17 32 32 32 32 32 32 32 32 32 32 17 17 17 17 17 17 32 32 17 17 32 32 0 0 0 0 0 0 0 0 0 0 0 0 0 0
0 0 0 0 0 0 0 32 17 17 17 32 32 32 32 17 17 17 17 17 17 17 17 17 17 17 17 17 17 17 17 17 17 17 17 17 17 32 17 17 17 32 32 0 0 0 0 0 0 0 0 0 0 0 0 0 0
0 0 0 0 0 0 0 32 17 17 17 32 32 32 32 32 32 32 32 32 32 32 32 32 32 32 32 32 32 32 32 32 17 17 17 17 17 32 17 37 17 32 32 0 0 0 0 0 0 0 0 0 0 0 0 0 0
0 0 0 0 0 0 0 32 17 17 17 32 32 32 32 32 32 32 32 32 32 32 32 32 32 32 32 32 32 32 32 32 32 32 32 32 32 32 32 32 32 32 32 0 0 0 0 0 0 0 0 0 0 0 0 0 0
0 0 0 0 0 0 0 32 32 32 32 32 32 32 32 32 32 32 32 32 32 32 32 32 32 32 32 32 32 32 32 32 32 32 32 32 32 32 32 32 32 32 32 0 0 0 0 0 0 0 0 0 0 0 0 0 0
0 0 0 0 0 0 0 0 0 0 0 0 0 0 0 0 0 0 0 0 0 0 0 0 0 0 0 0 0 0 0 0 0 0 0 0 0 0 0 0 0 0 0 0 0 0 0 0 0 0 0 0 0 0 0 0 0
0 0 0 0 0 0 0 0 0 0 0 0 0 0 0 0 0 0 0 0 0 0 0 0 0 0 0 0 0 0 0 0 0 0 0 0 0 0 0 0 0 0 0 0 0 0 0 0 0 0 0 0 0 0 0 0 0
0 0 0 0 0 0 0 0 0 0 0 0 0 0 0 0 0 0 0 0 0 0 0 0 0 0 0 0 0 0 0 0 0 0 0 0 0 0 0 0 0 0 0 0 0 0 0 0 0 0 0 0 0 0 0 0 0
0 0 0 0 0 0 0 0 0 0 0 0 0 0 0 0 0 0 0 0 0 0 0 0 0 0 0 0 0 0 0 0 0 0 0 0 0 0 0 0 0 0 0 0 0 0 0 0 0 0 0 0 0 0 0 0 0
0 0 0 0 0 0 0 0 0 0 0 0 0 0 0 0 0 0 0 0 0 0 0 0 0 0 0 0 0 0 0 0 0 0 0 0 0 0 0 0 0 0 0 0 0 0 0 0 0 0 0 0 0 0 0 0 0
0 0 0 0 0 0 0 0 0 0 0 0 0 0 0 0 0 0 0 0 0 0 0 0 0 0 0 0 0 0 0 0 0 0 0 0 0 0 0 0 0 0 0 0 0 0 0 0 0 0 0 0 0 0 0 0 0