92 92 92 92 92 92 92 92 92 92 92 92 92 92 92 92 92 92 92 92 92 92 92 92 92 92 92 92 92 92 92 92 92 92 92 92 92 92 92 92 92 92 92 92 92 92 92 92 92 92 
92 92 92 92 92 92 92 92 92 93 92 92 92 92 92 92 92 92 92 92 92 92 92 92 92 92 92 92 92 92 92 92 92 92 92 92 92 92 92 92 92 92 92 92 92 92 92 92 92 92 
92 92 92 92 92 92 92 92 92 92 92 92 92 92 92 92 92 92 92 92 92 92 92 92 92 92 92 92 92 92 92 92 92 92 92 92 92 92 92 92 92 92 92 92 92 92 92 92 92 92 
92 92 92 93 92 92 92 92 92 92 92 92 92 92 92 92 92 92 92 92 92 92 92 92 92 92 92 93 92 92 92 92 92 92 92 93 92 92 92 92 92 92 92 92 92 92 92 92 92 92 
92 92 92 92 92 92 93 92 92 92 92 92 92 92 92 92 92 93 92 92 92 92 93 92 92 92 92 92 92 92 92 92 92 92 92 92 92 92 92 92 92 92 92 92 92 92 92 92 92 92 
92 92 92 92 92 92 92 92 92 92 92 92 93 92 92 92 92 92 92 92 92 92 92 92 92 92 92 92 92 93 92 93 92 92 92 92 92 92 92 92 92 92 92 92 92 92 92 92 92 92 
92 92 92 92 92 92 92 92 102 100 100 100 100 100 100 100 103 92 102 100 100 100 100 100 100 100 100 103 92 92 92 102 100 100 100 100 100 100 100 100 100 100 103 92 92 92 92 92 92 92 
92 93 92 92 92 92 92 92 98 90 32 32 32 32 32 90 99 100 101 90 72 72 72 72 72 72 72 99 100 100 100 101 90 72 85 83 83 83 83 83 83 86 97 92 92 93 92 92 92 92 
92 92 92 92 92 92 92 92 98 90 32 17 17 17 32 90 90 90 90 90 72 94 95 95 95 96 72 90 90 90 90 90 90 90 81 76 76 76 76 76 76 80 97 92 92 92 92 92 92 92 
92 92 92 92 92 92 92 92 98 90 32 17 36 17 32 90 90 90 90 90 72 97 92 92 92 98 72 90 90 90 90 90 90 90 81 76 76 76 76 76 76 80 97 92 92 92 92 93 92 92 
92 92 92 92 92 92 92 92 98 90 32 17 17 17 32 90 90 90 90 90 72 97 92 92 92 98 72 90 90 90 90 90 90 90 81 76 76 76 76 76 76 80 97 93 92 92 92 92 92 92 
92 92 93 92 92 92 92 92 98 90 32 17 17 17 32 90 90 90 90 90 72 99 100 100 100 101 72 90 90 90 90 90 90 90 81 76 76 76 76 76 76 80 97 92 92 92 92 92 92 92 
92 92 92 92 92 93 92 92 98 90 32 32 17 32 32 90 90 90 90 90 72 72 85 83 86 72 72 72 72 72 72 72 72 72 87 78 78 79 76 77 78 88 97 92 92 92 92 92 92 92 
92 92 92 92 92 92 92 92 98 90 90 90 72 90 90 90 90 90 90 90 90 90 81 76 80 90 90 90 90 90 90 90 90 90 90 90 90 81 76 80 94 95 105 92 92 92 93 92 92 92 
92 92 92 92 92 92 92 92 104 96 90 90 72 90 90 90 90 90 90 90 90 90 81 76 80 90 90 90 90 72 72 72 72 90 90 90 90 81 76 80 97 92 92 92 92 92 92 92 92 92 
92 93 92 92 92 92 92 93 92 98 90 90 72 90 90 90 90 90 90 90 90 90 81 76 80 90 72 72 72 72 72 72 72 72 90 90 90 81 76 80 97 93 92 92 92 92 92 92 92 92 
92 92 92 92 92 92 92 92 102 101 90 90 72 90 90 90 90 90 90 90 90 90 81 76 80 72 72 72 72 72 72 72 72 90 90 90 90 81 76 80 97 92 92 93 92 92 92 92 92 92 
92 92 92 92 92 92 92 102 101 90 90 90 72 90 90 90 90 90 90 90 90 90 81 76 80 90 72 72 72 72 72 72 72 90 90 90 83 84 76 80 97 92 92 92 92 92 92 92 92 92 
92 92 92 92 92 92 92 98 90 90 72 72 72 90 90 90 90 90 90 90 90 90 81 76 80 90 90 72 72 72 72 72 72 90 90 81 76 76 76 80 97 92 92 92 92 92 93 92 92 92 
92 92 92 92 92 93 92 98 90 90 72 90 90 90 90 90 90 90 90 90 90 72 81 76 80 72 90 90 90 90 90 90 90 90 90 81 76 77 78 88 97 92 92 92 92 92 92 92 92 92 
92 92 92 92 92 92 92 98 90 90 72 90 90 72 85 83 83 83 83 83 83 83 84 76 82 83 83 83 83 86 90 90 90 85 83 84 76 80 72 90 97 92 92 93 92 92 92 92 92 92 
92 92 92 93 92 92 92 98 90 90 72 90 90 72 81 76 76 76 76 76 76 76 76 76 76 76 76 76 76 80 72 72 72 81 76 76 76 80 72 94 105 92 92 92 92 92 92 92 92 92 
92 92 92 92 92 92 92 98 90 90 72 90 90 72 87 78 78 78 78 78 78 78 79 76 77 78 78 78 78 88 90 90 90 87 78 79 76 80 73 97 92 92 93 92 92 92 92 92 92 92 
92 92 92 92 92 92 92 104 96 90 72 90 90 72 90 90 90 90 90 90 90 72 81 76 80 72 90 90 90 90 90 90 90 90 90 81 76 80 72 97 92 92 92 92 92 92 92 92 92 92 
92 92 92 92 92 92 92 92 98 90 72 90 90 72 90 90 90 90 90 90 90 90 81 76 80 90 90 90 90 90 90 90 90 90 90 81 76 80 72 97 92 92 92 92 92 92 92 92 92 92 
92 92 92 92 92 92 92 102 101 90 72 90 90 72 72 90 90 90 90 90 90 90 81 76 80 90 90 90 90 90 90 90 90 90 90 81 76 80 72 97 92 92 92 92 92 92 93 92 92 92 
92 92 92 93 92 92 92 98 90 90 72 90 90 90 72 90 90 90 90 90 90 90 81 76 80 90 90 90 90 90 90 90 90 90 90 81 76 80 72 97 92 92 92 92 92 92 92 92 92 92 
92 92 92 92 92 92 92 98 90 90 72 90 90 90 72 90 90 90 90 90 90 90 81 76 80 72 72 72 90 90 90 90 90 90 90 81 76 80 72 97 92 92 92 92 92 92 92 92 92 92 
92 92 92 92 92 92 92 98 90 90 72 90 90 90 72 90 90 90 90 90 90 90 81 76 80 90 90 72 90 90 90 90 90 90 90 81 76 80 72 97 92 92 93 92 92 92 92 92 92 92 
92 92 93 92 92 92 92 98 90 90 72 72 72 72 72 72 90 90 90 90 90 90 81 76 80 90 90 72 90 90 72 90 90 90 90 87 78 88 72 97 92 92 92 92 92 92 92 92 92 92 
92 92 92 92 92 92 92 98 90 90 72 73 72 72 72 72 90 90 90 90 90 90 81 76 80 90 90 72 90 90 72 90 90 90 90 90 72 90 94 105 92 92 92 92 92 92 92 92 92 92 
92 92 92 92 92 92 93 104 96 90 72 72 72 72 72 72 90 90 90 90 90 90 81 76 80 90 90 72 72 72 72 90 90 90 90 90 72 72 97 92 93 92 92 92 92 92 92 92 92 92 
92 92 92 92 92 92 92 92 98 90 72 72 72 73 72 72 90 90 90 90 90 90 81 76 80 90 90 90 90 90 90 90 90 90 90 72 72 72 97 92 92 92 92 92 92 92 92 93 92 92 
92 92 92 92 92 92 92 92 98 90 72 72 72 72 72 72 90 90 90 90 90 90 81 76 80 90 90 90 90 90 90 90 90 90 90 72 72 73 97 92 92 92 92 92 92 92 92 92 92 92 
92 92 92 92 93 92 92 92 98 90 72 72 72 72 72 72 90 90 90 90 90 90 81 76 80 90 90 90 90 90 90 90 90 90 90 72 72 72 97 92 92 92 92 92 92 92 92 92 92 92 
92 92 92 92 92 92 92 102 101 90 90 90 90 90 90 90 90 90 90 90 90 90 87 78 88 90 90 90 90 90 90 90 90 90 90 72 72 72 99 103 92 92 92 92 92 92 92 92 92 92 
92 92 92 92 92 92 92 98 90 90 90 90 90 90 90 90 90 90 90 90 72 72 72 72 72 72 72 90 90 90 90 90 90 90 72 72 72 72 72 99 103 92 92 93 92 92 92 92 92 92 
92 92 92 92 92 92 92 98 90 90 90 90 90 90 90 90 90 90 90 72 72 72 72 73 72 72 72 72 90 90 72 90 90 72 72 73 72 72 72 72 97 92 92 92 92 92 92 92 92 92 
92 92 92 92 92 92 92 98 90 90 90 90 90 90 90 90 90 90 90 72 72 72 72 72 72 72 72 72 90 90 90 90 72 72 72 72 72 72 72 72 97 92 92 92 92 92 92 92 92 92 
92 92 92 92 92 92 92 98 90 90 106 90 90 90 90 90 90 90 90 72 72 72 72 72 72 72 73 72 72 90 90 90 72 72 72 72 72 90 72 73 97 92 92 92 92 92 92 92 92 92 
92 92 92 92 92 93 92 98 90 90 72 90 90 72 72 72 72 72 72 72 73 72 72 72 72 72 72 72 72 72 72 72 72 72 90 72 72 72 72 72 97 92 92 92 92 92 92 92 92 92 
92 92 92 92 92 92 92 98 90 90 72 72 72 72 90 94 95 95 96 72 72 72 72 106 72 72 72 94 95 95 96 72 72 72 72 72 72 72 72 72 97 92 92 92 92 92 92 92 92 92 
92 93 92 92 92 92 92 98 90 90 90 90 90 90 94 105 92 92 104 96 72 72 72 72 72 72 94 105 92 92 98 72 72 90 72 72 90 72 72 72 97 92 92 92 92 92 93 92 92 92 
92 92 92 92 92 92 92 104 95 95 95 95 95 95 105 92 92 92 92 104 95 95 95 95 95 95 105 92 92 92 104 96 72 72 72 72 72 72 94 95 105 92 93 92 92 92 92 92 92 92 
92 92 92 92 92 92 92 92 92 92 92 92 92 92 93 92 92 92 92 92 92 92 92 92 92 92 92 92 93 92 92 104 95 95 95 95 95 95 105 92 92 92 92 92 92 92 92 92 92 92 
92 92 92 92 93 92 92 92 92 92 92 92 92 92 92 92 92 92 92 92 92 92 92 92 92 92 92 92 92 92 92 92 93 92 92 92 92 92 92 93 92 92 92 92 92 92 92 92 92 92 
92 92 92 92 92 92 92 92 92 93 92 92 92 92 92 92 92 92 92 92 92 92 92 93 92 92 92 92 92 92 92 92 92 92 92 92 92 92 92 92 92 92 92 92 92 93 92 92 92 92 
92 92 92 92 92 92 92 92 92 92 92 92 92 92 92 92 92 92 92 92 92 92 92 92 92 92 92 92 92 92 92 92 92 92 92 92 92 92 92 92 92 92 92 92 92 92 92 92 92 92 
92 92 92 92 92 92 92 92 92 92 92 92 92 92 92 92 92 92 92 92 92 92 92 92 92 92 92 92 92 92 92 92 92 92 92 92 92 92 92 92 92 92 92 92 92 92 92 92 92 92 
92 92 92 92 92 92 92 92 92 92 92 92 92 92 92 92 92 92 92 92 92 92 92 92 92 92 92 92 92 92 92 92 92 92 92 92 92 92 92 92 92 92 92 92 92 92 92 92 92 92 