92 92 92 92 92 92 92 92 92 92 92 92 92 92 92 92 92 92 92 92 92 92 92 92 92 92 92 92 92 92 92 92 92 92 92 92 92 92 92 92 92 92 92 92 92 92 92 92 92 92 92 92 92 92 92 92 92 92 92 92 92 92 92 92 92 92 92 92 92 92 92 92 92 92 92 92 92 92 92 92 92 92 92 92 92 92 92 92 92 92 92 92 92 92 92 92 92 92 92 92 
92 92 92 92 92 92 92 92 92 92 92 92 92 92 92 92 92 92 92 92 92 92 92 92 92 92 92 92 92 92 92 92 92 92 92 92 92 92 92 92 92 92 92 92 92 92 92 92 92 92 92 92 92 92 92 92 92 92 92 92 92 92 92 92 92 92 92 92 92 92 92 92 92 92 92 92 92 92 92 92 92 92 92 92 92 92 92 92 92 92 92 92 92 92 92 92 92 92 92 92 
92 92 92 92 92 92 92 92 92 92 92 92 92 92 92 92 92 92 92 92 92 92 92 92 92 92 92 92 92 92 92 92 92 92 92 92 92 92 92 92 92 92 92 92 92 92 92 92 92 92 92 92 92 92 92 92 92 92 92 92 92 92 92 92 92 92 92 92 92 92 92 92 92 92 92 92 92 92 92 92 92 92 92 92 92 92 92 92 92 92 92 92 92 92 92 92 92 92 92 92 
92 92 92 92 92 92 92 92 92 92 92 92 92 92 92 92 92 92 92 92 92 92 92 92 92 92 92 92 92 92 92 92 92 92 92 92 92 92 92 92 92 92 92 92 92 92 92 92 92 92 92 92 92 92 92 92 92 92 92 92 92 92 92 92 92 92 92 92 92 92 92 92 92 92 92 92 92 92 92 92 92 92 92 92 92 92 92 92 92 92 92 92 92 92 92 92 92 92 92 92 
92 92 92 92 92 92 92 92 92 92 92 92 92 92 92 92 92 92 92 92 92 92 92 92 92 92 92 92 92 92 92 92 92 92 92 92 92 92 92 92 92 92 92 92 92 92 92 92 92 92 92 92 92 92 92 92 92 92 92 92 92 92 92 92 92 92 92 92 92 92 92 92 92 92 92 92 92 92 92 92 92 92 92 92 92 92 92 92 92 92 92 92 92 92 92 92 92 92 92 92 
92 92 92 92 92 92 92 92 92 92 92 92 92 92 92 92 92 92 92 92 92 92 92 92 92 92 92 92 92 92 92 92 92 92 92 92 92 92 92 92 92 92 92 92 92 92 92 92 92 92 92 92 92 92 92 92 92 92 92 92 92 92 92 92 92 92 92 92 92 92 92 92 92 92 92 92 92 92 92 92 92 92 92 92 92 92 92 92 92 92 92 92 92 92 92 92 92 92 92 92 
92 92 92 92 92 92 92 92 92 92 92 92 92 92 92 92 92 92 92 92 92 92 92 92 92 92 92 92 92 92 92 92 92 92 92 92 92 92 92 92 92 92 92 92 92 92 92 92 92 92 92 92 92 92 92 92 92 92 92 92 92 92 92 92 92 92 92 92 92 92 92 92 92 92 92 92 92 92 92 92 92 92 92 92 92 92 92 92 92 92 92 92 92 92 92 92 92 92 92 92 
92 92 93 92 93 92 92 93 92 102 100 100 100 100 100 100 100 100 100 100 100 100 100 100 100 100 100 100 100 100 100 100 100 100 100 100 100 100 100 100 100 100 100 100 100 100 100 100 100 100 100 100 100 100 100 100 100 100 100 100 100 100 100 100 100 100 100 100 100 100 100 100 100 100 100 100 100 100 100 100 100 100 100 100 100 100 100 100 100 100 103 92 93 92 92 92 92 93 92 92 
93 92 92 93 92 92 93 92 92 98 72 72 73 72 72 72 72 72 72 72 72 72 72 72 72 72 72 72 72 72 72 72 72 72 72 72 72 72 72 72 72 72 72 72 72 72 72 72 72 72 72 72 72 72 72 72 72 72 72 72 72 72 72 72 72 72 72 72 72 72 72 72 72 72 72 72 72 72 72 72 72 72 72 72 72 72 72 72 72 72 97 92 92 92 93 93 93 92 92 92
92 92 93 92 93 92 92 93 92 98 73 72 89 89 73 72 73 72 73 91 91 91 91 91 91 91 91 91 91 91 91 91 91 91 91 91 91 91 91 91 91 73 72 73 72 73 72 73 72 73 72 73 72 73 72 73 72 73 72 73 72 73 72 73 72 73 72 73 72 73 73 72 73 72 73 72 73 72 73 72 73 72 73 72 73 72 73 72 73 72 97 93 92 92 92 92 92 93 92 92 
93 92 92 93 92 92 93 92 92 98 72 72 89 72 72 72 72 72 72 91 34 34 34 34 34 34 34 34 34 34 34 34 34 34 34 34 34 34 34 34 91 72 72 72 72 72 72 72 72 72 72 72 72 72 72 72 72 72 72 72 72 72 72 72 72 72 72 72 72 72 72 72 72 72 72 72 72 72 72 72 72 72 72 72 72 72 72 72 72 72 97 92 92 92 93 93 93 92 92 92
92 92 93 92 93 92 92 93 92 98 72 73 73 73 72 73 72 73 72 91 34 34 34 34 34 34 34 34 34 34 34 34 34 34 34 34 34 34 34 34 91 72 73 72 73 72 73 72 73 72 73 72 73 72 73 72 73 72 73 72 73 72 73 72 73 72 73 72 73 72 72 73 72 73 72 73 72 73 72 73 72 73 72 73 72 73 72 73 72 73 97 93 92 92 92 92 92 93 92 92 
93 92 92 93 92 92 93 92 92 98 73 72 72 72 73 72 73 72 73 91 34 34 34 34 34 34 34 34 34 34 34 34 34 34 34 34 34 34 34 34 91 91 72 73 72 73 72 73 72 73 72 73 72 73 72 73 72 73 72 73 72 73 72 73 72 73 72 73 72 73 73 72 73 72 73 72 73 72 73 72 73 72 73 72 73 72 73 72 73 72 97 92 92 92 93 93 93 92 92 92
92 92 93 92 93 92 92 93 92 98 72 72 73 72 72 72 72 72 72 91 34 34 34 34 34 34 34 34 34 34 34 34 34 34 34 34 34 34 34 34 91 91 72 72 72 72 72 72 72 72 72 72 72 72 72 72 72 72 72 72 72 72 72 72 72 72 72 72 72 72 72 72 72 72 72 72 72 72 72 72 72 72 72 72 72 72 72 72 72 72 97 93 92 92 92 92 92 93 92 92 
93 92 92 93 92 92 93 92 92 98 73 72 73 72 73 72 73 72 73 91 34 34 34 34 34 34 34 34 34 34 34 34 34 34 34 34 34 34 34 34 91 91 72 73 72 73 72 73 72 73 72 73 72 73 72 73 72 73 72 73 72 73 72 73 72 73 72 73 72 73 73 72 73 72 73 72 73 72 73 72 73 72 73 72 73 72 73 72 73 72 97 92 92 92 93 93 93 92 92 92 
92 92 93 92 93 92 92 93 92 98 72 72 72 72 72 72 72 72 72 91 34 34 34 34 34 34 34 34 34 34 34 34 34 34 34 34 34 34 34 34 91 91 72 72 72 72 72 72 72 72 72 72 72 85 83 83 83 83 83 83 83 83 83 83 83 83 83 83 83 83 83 83 83 83 83 86 72 72 72 72 72 72 72 72 72 72 72 72 72 72 97 93 92 92 92 92 92 93 92 92
93 92 92 93 92 92 93 92 92 98 72 73 73 73 72 73 72 73 72 91 34 34 34 34 34 34 34 34 34 34 34 34 34 34 34 34 34 34 34 34 91 91 73 72 73 72 73 72 73 72 73 72 73 81 108 108 108 108 108 108 108 108 108 108 108 108 108 108 108 108 108 108 108 108 108 80 72 73 72 73 72 73 72 73 72 73 72 73 72 73 97 92 92 92 93 93 93 92 92 92
92 92 93 92 93 92 92 93 92 98 72 72 90 90 72 72 72 72 91 91 34 34 34 34 34 34 34 34 34 34 34 34 34 34 34 34 34 34 34 34 91 91 91 72 72 72 72 72 72 72 72 72 72 81 108 77 78 78 78 78 78 78 78 78 78 78 78 78 78 78 78 78 78 78 78 88 72 72 72 72 72 72 72 72 72 72 72 72 72 72 97 93 92 92 92 92 92 93 92 92
93 92 92 93 92 92 93 92 92 98 73 72 72 90 73 72 73 72 91 91 34 34 34 34 34 34 34 34 34 34 34 34 34 34 34 34 34 34 34 34 91 91 91 73 72 73 72 73 72 73 72 73 72 81 108 80 72 73 72 73 72 73 72 73 72 73 72 73 72 73 73 72 73 72 73 72 73 72 73 72 73 72 73 72 73 72 73 72 73 72 97 92 92 92 93 93 93 92 92 92
92 92 93 92 93 92 92 93 92 98 72 72 72 72 72 72 72 72 91 91 34 34 34 34 34 34 34 34 34 34 34 34 34 34 34 34 34 34 34 34 91 91 91 72 72 72 72 72 72 72 72 72 72 81 108 80 72 72 72 72 72 72 72 72 72 72 72 72 72 72 72 72 72 72 72 72 72 72 72 72 72 72 72 72 72 72 72 72 72 72 97 93 92 92 92 92 92 93 92 92 
93 92 92 93 92 92 93 92 92 98 73 72 72 72 73 72 73 72 91 91 34 34 34 34 34 34 34 34 34 34 34 34 34 34 34 34 34 34 34 34 91 91 72 73 72 73 72 73 72 73 72 73 72 81 108 80 72 73 72 73 72 73 72 73 72 73 72 73 72 73 73 72 73 72 73 72 73 72 73 72 73 72 73 72 73 72 73 72 73 72 97 92 92 92 93 93 93 92 92 92 
92 92 93 92 93 92 92 93 92 98 72 72 72 72 72 72 72 72 72 91 34 34 34 34 34 34 34 34 34 34 34 34 34 34 34 34 34 34 34 34 91 91 72 72 72 72 72 72 72 72 72 72 72 81 108 80 72 72 72 72 72 72 72 72 72 72 72 72 72 72 72 72 72 72 72 72 72 72 72 72 72 72 72 72 72 72 72 72 72 72 97 93 92 92 92 92 92 93 92 92 
93 92 92 93 92 92 93 92 92 98 72 73 72 73 72 73 72 73 72 91 34 34 34 34 34 34 34 34 34 34 34 34 34 34 34 34 34 34 34 34 91 91 73 72 73 72 73 72 73 72 73 72 73 81 108 80 73 72 73 72 73 72 73 72 73 72 73 72 73 72 72 73 72 73 72 73 72 73 72 73 72 73 72 73 72 73 72 73 72 73 97 92 92 92 93 93 93 92 92 92
92 92 93 92 93 92 92 93 92 98 73 72 72 72 73 72 73 72 73 91 34 34 34 34 34 34 34 34 34 34 34 34 34 34 34 34 34 34 34 34 91 73 72 73 72 73 72 73 72 73 72 73 72 81 108 80 72 73 72 73 72 73 72 73 72 73 72 73 72 73 73 72 73 72 73 72 73 72 73 72 73 72 73 72 73 72 73 72 73 72 97 93 92 92 92 92 92 93 92 92 
93 92 92 93 92 92 93 92 92 98 72 72 72 72 72 72 72 72 72 91 34 34 34 34 34 34 34 34 34 34 34 34 34 34 34 34 34 34 34 34 91 72 72 72 72 72 72 72 72 72 72 72 72 81 108 80 72 72 72 72 72 72 72 72 72 72 72 72 72 72 72 72 72 72 72 72 72 72 72 72 72 72 72 72 72 72 72 72 72 72 97 92 92 92 93 93 93 92 92 92
92 92 93 92 93 92 92 93 92 98 72 72 73 72 72 72 72 72 72 91 34 34 34 34 34 34 34 34 34 34 34 34 34 34 34 34 34 34 34 34 91 72 72 72 72 72 72 72 72 72 72 72 72 81 108 80 72 72 72 72 72 72 72 72 72 72 72 72 72 72 72 72 72 72 72 72 72 72 72 72 72 72 72 72 72 72 72 72 72 72 97 93 92 92 92 92 92 93 92 92
93 92 92 93 92 92 93 92 92 98 73 72 72 72 73 72 73 72 73 91 91 91 91 91 91 91 91 91 72 73 72 91 91 91 91 91 91 91 91 91 91 73 72 73 72 73 72 73 72 73 72 73 72 81 108 80 72 73 72 73 72 73 72 73 72 73 72 73 72 73 73 72 73 72 73 72 73 72 73 72 73 72 73 72 73 72 73 72 73 72 97 92 92 92 93 93 93 92 92 92
92 92 93 92 93 92 92 93 92 98 72 72 72 72 72 72 72 72 72 72 72 72 72 72 72 72 72 72 72 72 72 72 72 72 72 72 72 72 72 72 72 72 72 72 72 72 72 72 72 72 72 72 72 81 108 80 72 72 72 72 72 72 72 72 72 72 72 72 72 72 72 72 72 72 72 72 72 72 72 72 72 72 72 72 72 72 72 72 72 72 97 93 92 92 92 92 92 93 92 92 
93 92 92 93 92 92 93 92 92 98 72 72 72 72 72 72 72 72 72 72 72 72 72 72 72 72 72 72 72 72 72 72 72 72 72 72 72 72 72 72 72 72 72 72 72 72 72 72 72 72 72 72 72 81 108 80 72 72 72 72 72 72 72 72 72 72 72 72 72 72 72 72 72 72 72 72 72 72 72 72 72 72 72 72 72 72 72 72 72 72 97 92 92 92 93 93 93 92 92 92 
92 92 93 92 93 92 92 93 92 98 73 72 72 72 73 72 73 72 73 72 73 72 73 72 73 72 73 72 73 72 73 72 73 72 73 72 73 72 73 72 73 73 72 73 72 73 72 73 72 73 72 73 72 81 108 80 72 73 72 73 72 73 72 73 72 73 72 73 72 73 73 72 73 72 73 72 73 72 73 72 73 72 73 72 73 72 73 72 73 72 97 93 92 92 92 92 92 93 92 92
93 92 92 93 92 92 93 92 92 98 72 72 72 72 72 72 72 72 72 72 72 72 72 72 72 72 72 72 72 72 72 72 72 72 72 72 72 72 72 72 72 72 72 72 72 72 72 72 72 72 72 72 72 81 108 80 72 72 72 72 72 72 72 72 72 72 72 72 72 72 72 72 72 72 72 72 72 72 72 72 72 72 72 72 72 72 72 72 72 72 97 92 92 92 93 93 93 92 92 92
92 92 93 92 93 92 92 93 92 98 73 72 72 72 73 72 73 72 73 72 73 72 73 72 73 72 73 72 85 83 86 72 73 72 73 72 73 72 73 72 73 73 72 73 72 73 72 73 72 73 72 73 72 81 108 80 72 73 72 73 72 73 72 73 72 73 72 73 85 83 86 72 72 72 73 72 73 72 73 72 73 72 73 72 73 72 73 72 73 72 97 92 92 92 93 93 93 92 92 92
93 92 92 93 92 92 93 92 92 98 72 72 72 72 72 72 72 72 72 72 72 72 72 72 72 72 72 72 81 108 80 72 72 72 72 72 72 72 72 72 72 72 72 72 72 72 72 72 72 72 72 72 72 81 108 80 72 72 72 72 72 72 72 72 72 72 72 72 81 108 80 72 72 72 72 72 72 72 72 72 72 72 72 72 72 72 72 72 72 72 97 93 92 92 92 92 92 93 92 92
92 92 93 92 93 92 92 93 92 98 72 72 73 72 72 72 72 72 72 72 72 85 83 83 83 83 83 83 84 108 82 83 83 83 83 83 83 83 83 86 72 72 72 72 72 72 72 72 72 72 72 85 83 84 108 82 83 83 83 83 83 83 83 83 83 83 83 83 84 108 80 72 72 72 72 72 72 72 72 72 72 72 72 72 72 72 72 72 72 72 97 92 92 92 93 93 93 92 92 92 
93 92 92 93 92 92 93 92 92 98 72 72 72 72 72 72 72 72 72 72 72 81 108 108 108 108 108 108 108 108 108 108 108 108 108 108 108 108 108 80 72 72 72 72 72 72 72 72 72 72 72 81 108 108 108 108 108 108 108 108 108 108 108 108 108 108 108 108 108 108 80 72 72 72 72 72 72 72 72 72 72 72 72 72 72 72 72 72 72 72 97 92 92 92 93 93 93 92 92 92 
92 92 93 92 93 92 92 93 92 98 73 72 72 72 73 72 73 72 73 72 73 87 78 78 78 78 78 78 79 108 77 78 78 78 78 78 78 78 78 88 72 72 72 73 72 73 72 73 72 73 72 87 78 78 78 78 78 78 78 78 78 78 78 78 78 78 78 78 79 108 80 72 72 72 72 72 72 72 73 72 73 72 73 72 73 72 73 72 73 72 97 93 92 92 92 92 92 93 92 92 
93 92 92 93 92 92 93 92 92 98 72 73 72 73 72 73 72 73 72 73 72 73 72 73 72 73 72 73 81 108 80 73 72 73 72 73 72 73 72 73 72 72 73 72 73 72 73 72 73 72 73 72 73 72 73 72 73 72 73 72 73 72 73 72 73 72 73 72 81 108 80 73 72 73 72 73 72 73 72 73 72 73 72 73 72 73 72 73 72 73 97 92 92 92 93 93 93 92 92 92
92 92 93 92 93 92 92 93 92 98 73 72 72 72 73 72 73 72 73 72 73 72 73 72 73 72 73 72 81 108 80 72 73 72 73 72 73 72 73 72 73 73 72 73 72 73 72 73 72 73 72 73 72 73 72 73 72 73 72 73 72 73 72 73 72 73 72 73 81 108 80 72 73 72 73 72 73 72 73 72 73 72 73 72 73 72 73 72 73 72 97 93 92 92 92 92 92 93 92 92
93 92 92 93 92 92 93 92 92 98 72 72 72 72 72 72 72 72 72 72 72 72 72 72 72 72 72 72 81 108 80 72 72 72 72 72 72 72 72 72 72 72 72 72 72 72 72 72 72 72 72 72 72 72 72 72 72 72 72 72 72 72 72 72 72 72 72 72 81 108 80 72 72 72 72 72 72 72 72 72 72 72 72 72 72 72 72 72 72 72 97 92 92 92 93 93 93 92 92 92
92 92 93 92 93 92 92 93 92 98 73 72 72 72 73 72 73 72 73 72 73 72 73 72 73 72 73 72 81 108 80 72 73 72 73 72 73 72 73 72 73 73 72 73 72 73 72 73 72 73 72 73 72 73 72 73 72 73 72 73 72 73 72 73 72 73 72 73 81 108 80 72 73 72 73 72 73 72 73 72 73 72 73 72 73 72 73 72 73 72 97 93 92 92 92 92 92 93 92 92
93 92 92 93 92 92 93 92 92 98 72 72 73 72 72 72 72 72 72 72 72 72 72 72 72 72 72 72 81 108 80 72 72 72 72 72 72 72 72 72 72 72 72 72 72 72 72 72 72 72 72 72 72 72 72 72 72 72 72 72 72 72 72 72 72 72 72 72 81 108 80 72 72 72 72 72 72 72 72 72 72 72 72 72 72 72 72 72 72 72 97 92 92 92 93 93 93 92 92 92 
92 92 93 92 93 92 92 93 92 98 73 72 72 72 73 72 73 72 73 72 73 72 73 72 73 72 73 72 81 108 80 72 73 72 73 72 73 72 73 72 73 73 72 73 72 73 72 73 72 73 72 73 72 73 72 73 72 73 72 73 72 73 72 73 72 73 72 73 81 108 80 72 73 72 73 72 73 72 73 72 73 72 73 72 73 72 73 72 73 72 97 93 92 92 92 92 92 93 92 92
93 92 92 93 92 92 93 92 92 98 72 72 72 72 72 72 72 72 72 72 72 72 72 72 72 72 72 72 81 108 80 72 72 72 72 72 72 72 72 72 72 72 72 72 72 72 72 72 72 72 72 72 72 72 72 72 72 72 72 72 72 72 72 72 72 72 72 72 81 108 80 72 72 72 72 72 72 72 72 72 72 72 72 72 72 72 72 72 72 72 97 92 92 92 93 93 93 92 92 92 
92 92 93 92 93 92 92 93 92 98 73 72 72 72 73 72 73 72 73 72 73 72 73 72 73 72 73 72 81 108 80 72 73 72 73 72 73 72 73 72 73 73 72 73 72 73 72 73 72 73 72 73 72 73 72 73 72 73 72 73 72 73 72 73 72 73 72 73 81 108 80 72 73 72 73 72 73 72 73 72 73 72 73 72 73 72 73 72 73 72 97 93 92 92 92 92 92 93 92 92 
93 92 92 93 92 92 93 92 92 98 72 72 73 72 72 72 72 72 72 72 72 72 72 72 72 72 72 72 81 108 80 72 72 72 72 72 72 72 72 72 72 72 72 72 72 72 72 72 72 72 72 72 72 72 72 72 72 72 72 72 72 72 72 72 72 72 72 72 81 108 80 72 72 72 72 72 72 72 72 72 72 72 72 72 72 72 72 72 72 72 97 92 92 92 93 93 93 92 92 92
92 92 93 92 93 92 92 93 92 98 72 72 72 72 72 72 72 72 72 72 72 72 72 72 72 72 72 72 81 108 80 72 72 72 72 72 72 72 72 72 72 72 72 72 72 72 72 72 72 72 72 72 72 72 72 72 72 72 72 72 72 72 72 72 72 72 72 72 81 108 80 72 72 72 72 72 72 72 72 72 72 72 72 72 72 72 72 72 72 72 97 93 92 92 92 92 92 93 92 92 
93 92 92 93 92 92 93 92 92 98 72 72 72 72 72 72 72 72 72 72 72 72 72 72 72 72 72 72 81 108 80 72 72 72 72 72 72 72 72 72 72 72 72 72 72 72 72 72 72 72 72 72 72 72 72 72 72 72 72 72 72 72 72 72 72 72 72 72 81 108 80 72 72 72 72 72 72 72 72 72 72 72 72 72 72 72 72 72 72 72 97 92 92 92 93 93 93 92 92 92 
92 92 93 92 93 92 92 93 92 98 73 73 72 73 73 73 73 73 73 73 73 73 73 73 73 73 73 73 81 108 80 73 73 73 73 73 73 73 73 73 73 73 73 73 73 73 73 73 73 73 73 73 73 73 73 73 73 73 73 73 73 73 73 73 73 73 73 73 81 108 80 73 73 73 73 73 73 73 73 73 73 73 73 73 73 73 73 73 73 73 97 93 92 92 92 92 92 93 92 92
93 92 92 93 92 92 93 92 92 98 72 72 72 72 72 72 72 72 72 72 72 72 72 72 72 72 72 72 81 108 80 72 72 72 72 72 72 72 72 72 72 72 72 72 72 72 72 72 72 72 72 72 72 72 72 72 72 72 72 72 72 72 72 72 72 72 72 72 81 108 80 72 72 72 72 72 72 72 72 72 72 72 72 72 72 72 72 72 72 72 97 92 92 92 93 93 93 92 92 92
93 92 92 93 92 92 93 92 92 98 73 72 72 72 73 72 73 72 73 72 73 72 73 72 73 72 73 72 73 72 73 72 73 72 73 72 73 72 73 72 73 73 72 73 72 73 72 73 72 81 108 80 72 73 72 73 72 73 72 73 72 73 72 72 72 73 72 72 72 72 73 72 73 72 73 72 72 72 73 72 73 72 73 72 73 72 72 72 72 72 97 92 92 92 93 93 93 92 92 92
92 92 93 92 93 92 92 93 92 98 72 72 72 72 72 72 72 72 72 72 72 72 72 72 72 72 72 72 72 72 72 72 72 72 72 72 72 72 72 72 72 72 72 72 72 72 72 72 72 81 108 80 72 72 72 72 72 72 72 72 72 72 72 72 72 72 72 72 72 72 72 72 72 72 72 72 72 72 72 72 72 72 72 72 72 72 89 72 72 72 97 93 92 92 92 92 92 93 92 92 
93 92 92 93 92 92 93 92 92 98 72 72 72 72 72 72 72 72 72 72 72 72 72 72 72 72 72 72 72 72 72 72 72 72 72 72 72 72 72 72 72 72 72 72 72 72 72 72 72 81 108 82 83 83 83 83 83 83 83 83 83 83 83 83 83 83 83 83 83 83 83 83 83 83 83 83 83 83 86 72 72 72 72 72 72 72 89 72 72 72 97 92 92 92 93 93 93 92 92 92
92 92 93 92 93 92 92 93 92 98 73 72 72 72 73 72 73 72 73 72 73 72 73 72 73 72 73 72 73 72 73 72 73 72 73 72 73 72 73 72 73 73 72 73 72 73 72 73 72 81 108 108 108 108 108 108 108 108 108 108 108 108 108 108 108 108 108 108 108 108 108 108 108 108 108 108 108 108 80 72 73 106 73 72 73 72 72 72 73 72 97 93 92 92 92 92 92 93 92 92 
93 92 92 93 92 92 93 92 92 98 72 73 72 73 72 73 72 73 72 73 72 73 72 73 72 73 72 73 72 73 72 73 72 73 72 73 72 73 72 73 72 72 73 72 73 72 73 72 73 87 78 78 78 78 78 78 78 78 78 78 78 78 78 78 78 78 78 78 78 78 78 78 78 78 78 78 78 78 88 73 72 73 72 73 72 73 72 73 72 73 97 92 92 92 93 93 93 92 92 92 
92 92 93 92 93 92 92 93 92 98 72 72 72 72 72 72 72 72 72 72 72 72 72 72 72 72 72 72 72 72 72 72 72 72 72 72 72 72 72 72 72 72 72 72 72 72 72 72 72 72 72 72 72 72 72 72 72 72 72 72 72 72 72 72 72 72 72 72 72 72 72 72 72 72 72 72 72 72 72 72 72 72 72 72 72 72 72 72 72 72 97 93 92 92 92 92 92 93 92 92 
93 92 92 93 92 92 93 92 92 98 72 72 73 72 72 72 72 72 72 72 72 72 72 72 72 72 72 72 72 72 72 72 72 72 72 72 72 72 72 72 72 72 72 72 72 72 72 72 72 72 72 72 72 72 72 72 72 72 72 72 72 72 72 72 72 72 72 72 72 72 72 72 72 72 72 72 72 72 72 72 72 89 72 72 72 72 89 72 72 72 97 92 92 92 93 93 93 92 92 92 
92 92 93 92 93 92 92 93 92 98 72 72 72 72 72 72 72 72 72 72 72 72 72 72 72 72 72 72 72 72 72 72 72 72 72 72 72 72 72 72 72 72 72 72 72 72 72 72 72 72 72 72 72 72 72 72 72 72 72 72 72 72 72 72 72 72 72 72 72 72 72 72 72 72 72 72 72 72 72 72 72 72 72 89 72 72 89 72 72 72 97 93 92 92 92 92 92 93 92 92 
93 92 92 93 92 92 93 92 92 98 73 72 72 72 73 72 73 72 73 72 73 72 73 72 73 72 73 72 73 72 73 72 73 72 73 72 73 72 73 72 73 73 72 73 72 73 72 73 72 73 72 73 72 73 72 73 72 73 72 73 72 73 72 72 72 73 72 73 72 73 73 72 73 72 73 72 72 72 73 72 73 72 73 72 73 72 73 72 73 72 97 92 92 92 93 93 93 92 92 92 
92 92 93 92 93 92 92 93 92 98 72 72 72 72 72 72 72 72 72 72 72 72 72 72 72 72 72 72 72 72 72 72 72 72 72 72 72 72 72 72 72 72 72 72 72 72 72 72 72 72 72 72 72 72 72 72 72 72 72 72 72 72 72 72 72 72 72 72 72 72 72 72 72 72 72 72 72 72 72 72 72 72 72 72 72 72 72 72 72 72 97 93 92 92 92 92 92 93 92 92 
93 92 92 93 92 92 93 92 92 104 95 95 95 95 95 95 95 95 95 95 95 95 95 95 95 95 95 95 95 95 95 95 95 95 95 95 95 95 95 95 95 95 95 95 95 95 95 95 95 95 95 95 95 95 95 95 95 95 95 95 95 95 95 95 95 95 95 95 95 95 95 95 95 95 95 95 95 95 95 95 95 95 95 95 95 95 95 95 95 95 105 92 92 92 92 93 93 93 92 92 
92 92 93 92 92 93 92 93 92 93 92 92 92 92 92 92 93 92 92 92 92 92 93 92 92 92 92 92 92 92 92 92 92 92 92 92 92 92 92 92 92 92 92 93 92 92 92 92 92 92 92 92 92 92 92 92 92 92 93 92 92 92 92 92 92 92 92 92 92 92 92 92 92 92 92 92 93 92 92 92 92 92 92 92 92 92 92 92 92 92 92 92 92 92 92 92 92 92 92 92 
92 92 92 92 92 92 92 92 92 92 92 92 92 92 92 92 92 92 92 92 92 92 92 92 92 92 92 92 92 93 92 92 92 92 92 92 92 92 93 92 92 92 92 92 93 92 92 92 92 92 92 92 92 92 92 92 92 92 92 92 92 92 93 92 92 92 92 92 92 92 93 92 92 92 92 92 92 92 92 92 93 92 92 92 92 92 92 93 92 92 92 92 92 92 93 92 92 92 92 92 
92 92 92 92 93 92 92 92 93 92 92 92 92 92 92 92 92 92 92 92 92 92 92 93 92 92 92 92 92 92 92 92 92 92 92 92 92 92 92 92 92 92 92 92 92 92 92 92 92 93 92 92 92 93 92 92 92 92 92 92 92 92 92 92 92 92 92 92 92 92 92 92 92 92 92 92 92 92 93 92 92 92 92 92 92 92 92 92 92 92 92 92 92 92 92 92 92 92 92 92 
92 92 92 92 92 92 92 92 92 92 92 92 92 92 92 92 92 92 93 92 92 92 92 92 92 92 92 92 92 92 92 92 92 92 92 92 92 92 92 92 92 92 92 92 92 92 92 92 92 92 92 92 92 92 92 92 92 92 92 92 92 92 92 92 92 92 92 92 92 92 92 92 92 92 92 92 92 92 92 92 92 92 92 92 92 92 92 92 92 92 92 92 92 92 92 92 92 92 92 92 
92 92 92 92 93 92 92 92 92 92 92 92 93 92 92 92 92 92 92 92 92 92 92 92 92 92 92 92 92 92 92 92 92 92 92 92 92 92 92 92 92 93 92 92 92 92 92 93 92 92 92 92 92 92 92 92 93 92 92 92 93 92 92 93 92 92 92 92 92 92 92 92 92 92 92 92 93 92 92 92 92 92 92 92 92 92 92 92 93 92 92 92 92 92 92 92 93 92 92 92 
92 92 92 92 92 92 93 92 92 92 92 92 92 92 92 92 92 92 92 92 93 92 92 92 92 93 92 92 92 92 92 93 92 92 92 92 92 92 92 92 92 92 93 92 92 92 92 92 92 92 92 92 92 92 92 92 92 92 92 92 92 92 92 92 92 92 92 92 92 92 92 92 92 92 92 92 92 92 92 92 92 92 92 92 92 92 92 92 92 92 93 92 92 92 92 92 92 92 92 92 
92 92 92 92 92 92 92 92 92 92 92 92 92 92 92 92 92 92 92 92 92 92 92 92 92 92 92 92 92 92 92 92 92 92 92 92 92 92 92 92 92 92 92 92 92 92 92 92 92 92 92 92 92 92 92 92 92 92 92 92 92 92 92 92 92 92 92 92 92 92 92 92 92 92 92 92 92 92 92 92 92 92 92 92 92 92 92 92 92 92 92 92 92 92 92 92 92 92 92 92 