136 136 136 136 136 136 136 136 136 136 136 136 136 136 136 136 136 136 136 136 136 136 136 136 136 136 136 136 136 136 136 136 136 136 136 136 136 136 136 136 136 136 136 136 136 136 136 136 136 136 
136 136 136 136 136 136 136 136 136 137 136 136 136 136 136 136 136 136 136 136 136 136 136 136 136 136 136 136 136 136 136 136 136 136 136 136 136 136 136 136 136 136 136 136 136 136 136 136 136 136 
136 136 136 136 136 136 136 136 136 136 136 136 136 136 136 136 136 136 136 136 136 136 136 136 136 136 136 136 136 136 136 136 136 136 136 136 136 136 136 136 136 136 136 136 136 136 136 136 136 136 
136 136 136 137 136 136 136 136 136 136 136 136 136 136 136 136 136 136 136 136 136 136 136 136 136 136 136 137 136 136 136 136 136 136 136 137 136 136 136 136 136 136 136 136 136 136 136 136 136 136 
136 136 136 136 136 136 137 136 136 136 136 136 136 136 136 136 136 137 136 136 136 136 137 136 136 136 136 136 136 136 136 136 136 136 136 136 136 136 136 136 136 136 136 136 136 136 136 136 136 136 
136 136 136 136 136 136 136 136 136 136 136 136 137 136 136 136 136 136 136 136 136 136 136 136 136 136 136 136 136 137 136 137 136 136 136 136 136 136 136 136 136 136 136 136 136 136 136 136 136 136 
136 136 136 136 136 136 136 136 132 130 130 130 130 130 130 130 133 136 132 130 130 130 130 130 130 130 130 133 136 136 136 132 130 130 130 130 130 130 130 130 130 130 133 136 136 136 136 136 136 136 
136 137 136 136 136 136 136 136 128 140 32 32 32 32 32 140 129 130 131 140 110 110 110 110 110 110 110 129 130 130 130 131 140 110 120 118 118 118 118 118 118 121 127 136 136 137 136 136 136 136 
136 136 136 136 136 136 136 136 128 140 32 17 17 17 32 140 140 140 140 140 110 124 125 125 125 126 110 140 140 140 140 140 140 140 116 109 109 109 109 109 109 115 127 136 136 136 136 136 136 136 
136 136 136 136 136 136 136 136 128 140 32 17 36 17 32 140 140 140 140 140 110 127 136 136 136 128 110 140 140 140 140 140 140 140 116 109 109 109 109 109 109 115 127 136 136 136 136 137 136 136 
136 136 136 136 136 136 136 136 128 140 32 17 17 17 32 140 140 140 140 140 110 127 136 136 136 128 110 140 140 140 140 140 140 140 116 109 109 109 109 109 109 115 127 137 136 136 136 136 136 136 
136 136 137 136 136 136 136 136 128 140 32 17 17 17 32 140 140 140 140 140 110 129 130 130 130 131 110 140 140 140 140 140 140 140 116 109 109 109 109 109 109 115 127 136 136 136 136 136 136 136 
136 136 136 136 136 137 136 136 128 140 32 32 17 32 32 140 140 140 140 140 110 110 120 118 121 110 110 110 110 110 110 110 110 110 122 113 113 114 109 112 113 123 127 136 136 136 136 136 136 136 
136 136 136 136 136 136 136 136 128 140 140 140 110 140 140 140 140 140 140 140 140 140 116 109 115 140 140 140 140 140 140 140 140 140 140 140 140 116 109 115 124 125 135 136 136 136 137 136 136 136 
136 136 136 136 136 136 136 136 134 126 140 140 110 140 140 140 140 140 140 140 140 140 116 109 115 140 140 140 140 140 140 140 140 140 140 140 140 116 109 115 127 136 136 136 136 136 136 136 136 136 
136 137 136 136 136 136 136 137 136 128 140 140 110 140 140 140 140 140 140 140 140 140 116 109 115 140 140 140 140 140 140 140 140 140 140 140 140 116 109 115 127 137 136 136 136 136 136 136 136 136 
136 136 136 136 136 136 136 136 132 131 140 140 110 140 140 140 140 140 140 140 140 140 116 109 115 110 110 110 140 140 140 140 140 140 140 140 140 116 109 115 127 136 136 137 136 136 136 136 136 136 
136 136 136 136 136 136 136 132 131 140 140 140 110 140 140 140 140 140 140 140 140 140 116 109 115 140 140 140 140 140 140 140 140 140 140 120 118 119 109 115 127 136 136 136 136 136 136 136 136 136 
136 136 136 136 136 136 136 128 140 140 110 110 110 140 140 140 140 140 140 140 140 140 116 109 115 140 140 140 140 140 140 140 140 140 140 116 109 109 109 115 127 136 136 136 136 136 137 136 136 136 
136 136 136 136 136 137 136 128 140 140 110 140 140 140 140 140 140 140 140 140 140 110 116 109 115 110 140 140 140 140 140 140 140 140 140 116 109 112 113 123 127 136 136 136 136 136 136 136 136 136 
136 136 136 136 136 136 136 128 140 140 110 140 140 110 120 118 118 118 118 118 118 118 119 109 117 118 118 118 118 121 140 140 140 120 118 119 109 115 110 140 127 136 136 137 136 136 136 136 136 136 
136 136 136 137 136 136 136 128 140 140 110 140 140 110 116 109 109 109 109 109 109 109 109 109 109 109 109 109 109 115 110 110 110 116 109 109 109 115 110 124 135 136 136 136 136 136 136 136 136 136 
136 136 136 136 136 136 136 128 140 140 110 140 140 110 122 113 113 113 113 113 113 113 114 109 112 113 113 113 113 123 140 140 140 122 113 114 109 115 111 127 136 136 137 136 136 136 136 136 136 136 
136 136 136 136 136 136 136 134 126 140 110 140 140 110 140 140 140 140 140 140 140 110 116 109 115 110 140 140 140 140 140 140 140 140 140 116 109 115 110 127 136 136 136 136 136 136 136 136 136 136 
136 136 136 136 136 136 136 136 128 140 110 140 140 110 140 140 140 140 140 140 140 140 116 109 115 140 140 140 140 140 140 140 140 140 140 116 109 115 110 127 136 136 136 136 136 136 136 136 136 136 
136 136 136 136 136 136 136 132 131 140 110 140 140 110 110 140 140 140 140 140 140 140 116 109 115 140 140 140 140 140 140 140 140 140 140 116 109 115 110 127 136 136 136 136 136 136 137 136 136 136 
136 136 136 137 136 136 136 128 140 140 110 140 140 140 110 140 140 140 140 140 140 140 116 109 115 140 140 140 140 140 140 140 140 140 140 116 109 115 110 127 136 136 136 136 136 136 136 136 136 136 
136 136 136 136 136 136 136 128 140 140 110 140 140 140 110 140 140 140 140 140 140 140 116 109 115 110 110 110 140 140 140 140 140 140 140 116 109 115 110 127 136 136 136 136 136 136 136 136 136 136 
136 136 136 136 136 136 136 128 140 140 110 140 140 140 110 140 140 140 140 140 140 140 116 109 115 140 140 110 140 140 140 140 140 140 140 116 109 115 110 127 136 136 137 136 136 136 136 136 136 136 
136 136 137 136 136 136 136 128 140 140 110 110 110 110 110 110 140 140 140 140 140 140 116 109 115 140 140 110 140 140 110 140 140 140 140 122 113 123 110 127 136 136 136 136 136 136 136 136 136 136 
136 136 136 136 136 136 136 128 140 140 110 111 110 110 110 110 140 140 140 140 140 140 116 109 115 140 140 110 140 140 110 140 140 140 140 140 110 140 124 135 136 136 136 136 136 136 136 136 136 136 
136 136 136 136 136 136 137 134 126 140 110 110 110 110 110 110 140 140 140 140 140 140 116 109 115 140 140 110 110 110 110 140 140 140 140 140 110 110 127 136 137 136 136 136 136 136 136 136 136 136 
136 136 136 136 136 136 136 136 128 140 110 110 110 111 110 110 140 140 140 140 140 140 116 109 115 140 140 140 140 140 140 140 140 140 140 110 110 110 127 136 136 136 136 136 136 136 136 137 136 136 
136 136 136 136 136 136 136 136 128 140 110 110 110 110 110 110 140 140 140 140 140 140 116 109 115 140 140 140 140 140 140 140 140 140 140 110 110 111 127 136 136 136 136 136 136 136 136 136 136 136 
136 136 136 136 137 136 136 136 128 140 110 110 110 110 110 110 140 140 140 140 140 140 116 109 115 140 140 140 140 140 140 140 140 140 140 110 110 110 127 136 136 136 136 136 136 136 136 136 136 136 
136 136 136 136 136 136 136 132 131 140 140 140 140 140 140 140 140 140 140 140 140 140 122 113 123 140 140 140 140 140 140 140 140 140 140 110 110 110 129 133 136 136 136 136 136 136 136 136 136 136 
136 136 136 136 136 136 136 128 140 140 140 140 140 140 140 140 140 140 140 140 110 110 110 110 110 110 110 140 140 140 140 140 140 140 110 110 110 110 110 129 133 136 136 137 136 136 136 136 136 136 
136 136 136 136 136 136 136 128 140 140 140 140 140 140 140 140 140 140 140 110 110 110 110 111 110 110 110 110 140 140 110 140 140 110 110 111 110 110 110 110 127 136 136 136 136 136 136 136 136 136 
136 136 136 136 136 136 136 128 140 140 140 140 140 140 140 140 140 140 140 110 110 110 110 110 110 110 110 110 140 140 140 140 110 110 110 110 110 110 110 110 127 136 136 136 136 136 136 136 136 136 
136 136 136 136 136 136 136 128 140 140 138 140 140 140 140 140 140 140 140 110 110 110 110 110 110 110 111 110 110 140 140 140 110 110 110 110 110 140 110 111 127 136 136 136 136 136 136 136 136 136 
136 136 136 136 136 137 136 128 140 140 110 140 140 110 110 110 110 110 110 110 111 110 110 110 110 110 110 110 110 110 110 110 110 110 140 110 110 110 110 110 127 136 136 136 136 136 136 136 136 136 
136 136 136 136 136 136 136 128 140 140 110 110 110 110 140 124 125 125 126 110 110 110 110 110 110 110 110 124 125 125 126 110 110 110 110 110 110 110 110 110 127 136 136 136 136 136 136 136 136 136 
136 137 136 136 136 136 136 128 140 140 140 140 140 140 124 135 136 136 134 126 110 110 110 110 110 110 124 135 136 136 128 110 110 140 110 110 140 110 110 110 127 136 136 136 136 136 137 136 136 136 
136 136 136 136 136 136 136 134 125 125 125 125 125 125 135 136 136 136 136 134 125 125 125 125 125 125 135 136 136 136 134 126 110 110 110 110 110 110 124 125 135 136 137 136 136 136 136 136 136 136 
136 136 136 136 136 136 136 136 136 136 136 136 136 136 137 136 136 136 136 136 136 136 136 136 136 136 136 136 137 136 136 134 125 125 125 125 125 125 135 136 136 136 136 136 136 136 136 136 136 136 
136 136 136 136 137 136 136 136 136 136 136 136 136 136 136 136 136 136 136 136 136 136 136 136 136 136 136 136 136 136 136 136 137 136 136 136 136 136 136 137 136 136 136 136 136 136 136 136 136 136 
136 136 136 136 136 136 136 136 136 137 136 136 136 136 136 136 136 136 136 136 136 136 136 137 136 136 136 136 136 136 136 136 136 136 136 136 136 136 136 136 136 136 136 136 136 137 136 136 136 136 
136 136 136 136 136 136 136 136 136 136 136 136 136 136 136 136 136 136 136 136 136 136 136 136 136 136 136 136 136 136 136 136 136 136 136 136 136 136 136 136 136 136 136 136 136 136 136 136 136 136 
136 136 136 136 136 136 136 136 136 136 136 136 136 136 136 136 136 136 136 136 136 136 136 136 136 136 136 136 136 136 136 136 136 136 136 136 136 136 136 136 136 136 136 136 136 136 136 136 136 136 
136 136 136 136 136 136 136 136 136 136 136 136 136 136 136 136 136 136 136 136 136 136 136 136 136 136 136 136 136 136 136 136 136 136 136 136 136 136 136 136 136 136 136 136 136 136 136 136 136 136 