127 127 127 127 127 127 127 127 127 127 127 127 127 127 127 127 127 127 127 127 127 127 127 127 127 127 127 127 127 127 127 127 127 127 127 127 127 127 127 127 127 127 127 127 127 127 127 127 127 127 
127 127 127 127 127 127 127 127 127 128 127 127 127 127 127 127 127 127 127 127 127 127 127 127 127 127 127 127 127 127 127 127 127 127 127 127 127 127 127 127 127 127 127 127 127 127 127 127 127 127 
127 127 127 127 127 127 127 127 127 127 127 127 127 127 127 127 127 127 127 127 127 127 127 127 127 127 127 127 127 127 127 127 127 127 127 127 127 127 127 127 127 127 127 127 127 127 127 127 127 127 
127 127 127 128 127 127 127 127 127 127 127 127 127 127 127 127 127 127 127 127 127 127 127 127 127 127 127 128 127 127 127 127 127 127 127 128 127 127 127 127 127 127 127 127 127 127 127 127 127 127 
127 127 127 127 127 127 128 127 127 127 127 127 127 127 127 127 127 128 127 127 127 127 128 127 127 127 127 127 127 127 127 127 127 127 127 127 127 127 127 127 127 127 127 127 127 127 127 127 127 127 
127 127 127 127 127 127 127 127 127 127 127 127 128 127 127 127 127 127 127 127 127 127 127 127 127 127 127 127 127 128 127 128 127 127 127 127 127 127 127 127 127 127 127 127 127 127 127 127 127 127 
127 127 127 127 127 127 127 127 137 135 135 135 135 135 135 135 138 127 137 135 135 135 135 135 135 135 135 138 127 127 127 137 135 135 135 135 135 135 135 135 135 135 138 127 127 127 127 127 127 127 
127 128 127 127 127 127 127 127 133 124 32 32 32 32 32 124 134 135 136 124 107 107 107 107 107 107 107 134 135 135 135 136 125 107 119 117 117 117 117 117 117 120 132 127 127 128 127 127 127 127 
127 127 127 127 127 127 127 127 133 124 32 17 17 17 32 124 124 124 124 124 107 129 130 130 130 131 107 125 125 125 125 125 125 125 114 109 109 109 109 109 109 113 132 127 127 127 127 127 127 127 
127 127 127 127 127 127 127 127 133 124 32 17 36 17 32 124 124 124 124 124 107 132 127 127 127 133 107 125 125 125 125 125 125 125 114 109 109 109 109 109 109 113 132 127 127 127 127 128 127 127 
127 127 127 127 127 127 127 127 133 124 32 17 17 17 32 124 124 124 124 124 107 132 127 127 127 133 107 125 125 125 125 125 125 125 114 109 109 109 109 109 109 113 132 128 127 127 127 127 127 127 
127 127 128 127 127 127 127 127 133 124 32 17 17 17 32 124 124 124 124 124 107 134 135 135 135 136 107 125 125 125 125 125 125 125 114 109 109 109 109 109 109 113 132 127 127 127 127 127 127 127 
127 127 127 127 127 128 127 127 133 124 32 32 17 32 32 124 124 124 124 124 107 107 119 117 120 107 107 107 107 107 107 107 107 107 121 111 111 112 109 110 111 122 132 127 127 127 127 127 127 127 
127 127 127 127 127 127 127 127 133 124 124 124 107 124 124 124 124 124 124 124 124 124 114 109 113 125 125 125 125 125 125 125 125 125 125 125 125 114 109 113 129 130 140 127 127 127 128 127 127 127 
127 127 127 127 127 127 127 127 139 131 124 124 107 124 124 124 124 124 124 124 124 124 114 109 113 125 125 125 125 125 125 125 125 125 125 125 125 114 109 113 132 127 127 127 127 127 127 127 127 127 
127 128 127 127 127 127 127 128 127 133 124 124 107 124 124 124 124 124 124 124 124 124 114 109 113 125 125 125 125 125 125 125 125 125 125 125 125 114 109 113 132 128 127 127 127 127 127 127 127 127 
127 127 127 127 127 127 127 127 137 136 124 124 107 124 124 124 124 124 124 124 124 124 114 109 113 107 107 107 125 125 125 125 125 125 125 125 125 114 109 113 132 127 127 128 127 127 127 127 127 127 
127 127 127 127 127 127 127 137 136 123 124 124 107 124 124 124 124 124 124 124 124 124 114 109 113 125 125 125 125 125 125 125 125 125 125 119 117 118 109 113 132 127 127 127 127 127 127 127 127 127 
127 127 127 127 127 127 127 133 123 123 107 107 107 124 124 124 124 124 124 124 124 124 114 109 113 125 125 125 125 125 125 125 125 125 125 114 109 109 109 113 132 127 127 127 127 127 128 127 127 127 
127 127 127 127 127 128 127 133 123 123 107 123 123 124 124 124 124 124 124 124 124 107 114 109 113 107 125 125 125 125 125 125 125 125 125 114 109 110 111 122 132 127 127 127 127 127 127 127 127 127 
127 127 127 127 127 127 127 133 123 123 107 123 123 107 119 117 117 117 117 117 117 117 118 109 116 117 117 117 117 120 125 125 125 119 117 118 109 113 107 125 132 127 127 128 127 127 127 127 127 127 
127 127 127 128 127 127 127 133 123 123 107 123 123 107 114 109 109 109 109 109 109 109 109 109 109 109 109 109 109 113 107 107 107 114 109 109 109 113 107 129 140 127 127 127 127 127 127 127 127 127 
127 127 127 127 127 127 127 133 123 123 107 123 123 107 121 111 111 111 111 111 111 111 112 109 110 111 111 111 111 122 124 124 124 121 111 112 109 113 108 132 127 127 128 127 127 127 127 127 127 127 
127 127 127 127 127 127 127 139 131 123 107 123 123 107 123 123 123 123 123 123 123 107 114 109 113 107 124 124 124 124 124 124 124 124 124 114 109 113 107 132 127 127 127 127 127 127 127 127 127 127 
127 127 127 127 127 127 127 127 133 123 107 123 123 107 123 123 123 123 123 123 123 123 114 109 113 124 124 124 124 124 124 124 124 124 124 114 109 113 107 132 127 127 127 127 127 127 127 127 127 127 
127 127 127 127 127 127 127 137 136 123 107 123 123 107 107 123 123 123 123 123 123 123 114 109 113 124 124 124 124 124 124 124 124 124 124 114 109 113 107 132 127 127 127 127 127 127 128 127 127 127 
127 127 127 128 127 127 127 133 123 123 107 123 123 123 107 123 123 123 123 123 123 123 114 109 113 124 124 124 124 124 124 124 124 124 124 114 109 113 107 132 127 127 127 127 127 127 127 127 127 127 
127 127 127 127 127 127 127 133 123 123 107 123 123 123 107 123 123 123 123 123 123 123 114 109 113 107 107 107 124 124 124 124 124 124 124 114 109 113 107 132 127 127 127 127 127 127 127 127 127 127 
127 127 127 127 127 127 127 133 123 123 107 123 123 123 107 123 123 123 123 123 123 123 114 109 113 124 124 107 124 124 124 124 124 124 124 114 109 113 107 132 127 127 128 127 127 127 127 127 127 127 
127 127 128 127 127 127 127 133 123 123 107 107 107 107 107 107 123 123 123 123 123 123 114 109 113 124 124 107 124 124 107 124 124 124 124 121 111 122 107 132 127 127 127 127 127 127 127 127 127 127 
127 127 127 127 127 127 127 133 123 123 107 108 107 107 107 107 123 123 123 123 123 123 114 109 113 124 124 107 124 124 107 124 124 124 124 124 107 124 129 140 127 127 127 127 127 127 127 127 127 127 
127 127 127 127 127 127 128 139 131 123 107 107 107 107 107 107 123 123 123 123 123 123 114 109 113 124 124 107 107 107 107 124 124 124 124 124 107 107 132 127 128 127 127 127 127 127 127 127 127 127 
127 127 127 127 127 127 127 127 133 123 107 107 107 108 107 107 123 123 123 123 123 123 114 109 113 124 124 124 124 124 124 124 124 124 124 107 107 107 132 127 127 127 127 127 127 127 127 128 127 127 
127 127 127 127 127 127 127 127 133 123 107 107 107 107 107 107 123 123 123 123 123 123 114 109 113 124 124 124 124 124 124 124 124 124 124 107 107 108 132 127 127 127 127 127 127 127 127 127 127 127 
127 127 127 127 128 127 127 127 133 123 107 107 107 107 107 107 123 123 123 123 123 123 114 109 113 124 124 124 124 124 124 124 124 124 124 107 107 107 132 127 127 127 127 127 127 127 127 127 127 127 
127 127 127 127 127 127 127 137 136 123 123 123 123 123 123 123 123 123 123 123 123 123 121 111 122 124 124 124 124 124 124 124 124 124 124 107 107 107 134 138 127 127 127 127 127 127 127 127 127 127 
127 127 127 127 127 127 127 133 123 123 123 123 123 123 123 123 123 123 123 123 107 107 107 107 107 107 107 124 124 124 124 124 124 124 107 107 107 107 107 134 138 127 127 128 127 127 127 127 127 127 
127 127 127 127 127 127 127 133 123 123 123 123 123 123 123 123 123 123 123 107 107 107 107 108 107 107 107 107 124 124 107 124 124 107 107 108 107 107 107 107 132 127 127 127 127 127 127 127 127 127 
127 127 127 127 127 127 127 133 123 123 123 123 123 123 123 123 123 123 123 107 107 107 107 107 107 107 107 107 124 124 124 124 107 107 107 107 107 107 107 107 132 127 127 127 127 127 127 127 127 127 
127 127 127 127 127 127 127 133 123 123 141 123 123 123 123 123 123 123 123 107 107 107 107 107 107 107 108 107 107 124 124 124 107 107 107 107 107 123 107 108 132 127 127 127 127 127 127 127 127 127 
127 127 127 127 127 128 127 133 123 123 107 123 123 107 107 107 107 107 107 107 108 107 107 107 107 107 107 107 107 107 107 107 107 107 123 107 107 107 107 107 132 127 127 127 127 127 127 127 127 127 
127 127 127 127 127 127 127 133 123 123 107 107 107 107 123 129 130 130 131 107 107 107 107 107 107 107 107 129 130 130 131 107 107 107 107 107 107 107 107 107 132 127 127 127 127 127 127 127 127 127 
127 128 127 127 127 127 127 133 123 123 123 123 123 123 129 140 127 127 139 131 107 107 107 107 107 107 129 140 127 127 133 107 107 123 107 107 123 107 107 107 132 127 127 127 127 127 128 127 127 127 
127 127 127 127 127 127 127 139 130 130 130 130 130 130 140 127 127 127 127 139 130 130 130 130 130 130 140 127 127 127 139 131 107 107 107 107 107 107 129 130 140 127 128 127 127 127 127 127 127 127 
127 127 127 127 127 127 127 127 127 127 127 127 127 127 128 127 127 127 127 127 127 127 127 127 127 127 127 127 128 127 127 139 130 130 130 130 130 130 140 127 127 127 127 127 127 127 127 127 127 127 
127 127 127 127 128 127 127 127 127 127 127 127 127 127 127 127 127 127 127 127 127 127 127 127 127 127 127 127 127 127 127 127 128 127 127 127 127 127 127 128 127 127 127 127 127 127 127 127 127 127 
127 127 127 127 127 127 127 127 127 128 127 127 127 127 127 127 127 127 127 127 127 127 127 128 127 127 127 127 127 127 127 127 127 127 127 127 127 127 127 127 127 127 127 127 127 128 127 127 127 127 
127 127 127 127 127 127 127 127 127 127 127 127 127 127 127 127 127 127 127 127 127 127 127 127 127 127 127 127 127 127 127 127 127 127 127 127 127 127 127 127 127 127 127 127 127 127 127 127 127 127 
127 127 127 127 127 127 127 127 127 127 127 127 127 127 127 127 127 127 127 127 127 127 127 127 127 127 127 127 127 127 127 127 127 127 127 127 127 127 127 127 127 127 127 127 127 127 127 127 127 127 
127 127 127 127 127 127 127 127 127 127 127 127 127 127 127 127 127 127 127 127 127 127 127 127 127 127 127 127 127 127 127 127 127 127 127 127 127 127 127 127 127 127 127 127 127 127 127 127 127 127 