0 1 1 32 32 32 32 32 32 32 32 32 32 32 32 32 0 0 1 1 1 1 1 1 1 1 1 1 1 1 1 0 0 1 1 1 1 1 1 1 1 1 1 1 1 1 0 0 1 1 1 1 1 1 1 1 1 1 
0 1 1 1 1 1 1 1 1 1 1 1 1 1 1 32 0 0 0 0 0 0 0 0 0 0 0 0 0 0 1 0 0 0 0 0 0 0 0 0 0 0 0 0 0 1 0 0 0 0 0 0 0 0 0 0 0 0 
0 1 1 1 1 1 1 1 1 1 1 1 1 1 1 32 0 0 0 0 0 0 0 0 0 0 0 0 0 0 1 0 0 0 0 0 0 0 0 0 0 0 0 0 0 1 0 0 0 0 0 0 0 0 0 0 0 0 
0 1 1 1 1 1 1 1 1 1 1 1 1 1 1 32 0 0 0 0 0 0 0 0 0 0 0 0 0 0 1 0 0 0 0 0 0 0 0 0 0 0 0 0 0 1 0 0 0 0 0 0 0 0 0 0 0 0 
0 1 1 1 1 1 1 1 1 1 1 1 1 1 1 32 0 0 0 0 0 0 0 0 0 0 0 0 0 0 1 0 0 0 0 0 0 0 0 0 0 0 0 0 0 1 0 0 0 0 0 0 0 0 0 0 0 0 
0 1 1 1 1 1 1 1 1 1 1 1 1 1 1 32 0 0 0 0 0 0 0 0 0 0 0 0 0 0 1 0 0 0 0 0 0 0 0 0 0 0 0 0 0 1 0 0 0 0 0 0 0 0 0 0 0 0 
0 1 1 1 1 1 1 1 1 1 1 1 1 1 1 32 0 0 0 0 0 0 0 0 0 0 0 0 0 0 1 0 0 0 0 0 0 0 0 0 0 0 0 0 0 1 0 0 0 0 0 0 0 0 0 0 0 0 
0 1 1 1 1 1 1 18 18 18 18 1 1 1 1 32 0 0 0 0 0 0 2 2 2 2 0 0 0 0 1 0 0 0 0 0 0 2 2 2 2 0 0 0 0 1 0 0 0 0 0 0 2 2 2 2 0 0 
0 1 1 1 1 1 1 18 18 18 18 1 1 1 1 32 0 0 0 0 0 0 2 2 2 2 0 0 0 0 1 0 0 0 0 0 0 2 2 2 2 0 0 0 0 1 0 0 0 0 0 0 2 2 2 2 0 0 
0 1 1 1 1 1 1 18 18 18 18 1 1 1 1 32 0 0 0 0 0 0 2 2 2 2 0 0 0 0 1 0 0 0 0 0 0 2 2 2 2 0 0 0 0 1 0 0 0 0 0 0 2 2 2 2 0 0 
0 1 1 1 1 1 1 18 18 18 18 1 1 1 1 32 0 0 0 0 0 0 2 2 2 2 0 0 0 0 1 0 0 0 0 0 0 2 2 2 2 0 0 0 0 1 0 0 0 0 0 0 2 2 2 2 0 0 
0 1 32 32 32 32 32 32 32 32 32 32 32 32 32 32 0 1 1 1 1 1 1 1 1 1 1 1 1 1 1 0 1 1 1 1 1 1 1 1 1 1 1 1 1 1 0 1 1 1 1 1 1 1 1 1 1 1  
1 0 0 1 1 1 1 1 1 1 1 1 1 1 1 1 0 0 1 1 1 1 1 1 1 1 1 1 1 1 1 0 0 1 1 1 1 1 1 1 1 1 1 1 1 1 0 0 1 1 1 1 1 1 1 1 1 1 
1 0 0 0 0 0 0 0 0 0 0 0 0 0 0 1 0 0 0 0 0 0 0 0 0 0 0 0 0 0 1 0 0 0 0 0 0 0 0 0 0 0 0 0 0 1 0 0 0 0 0 0 0 0 0 0 0 0 
1 0 0 0 0 0 0 0 0 0 0 0 0 0 0 1 0 0 0 0 0 0 0 0 0 0 0 0 0 0 1 0 0 0 0 0 0 0 0 0 0 0 0 0 0 1 0 0 0 0 0 0 0 0 0 0 0 0 
1 0 0 0 0 0 0 0 0 0 0 0 0 0 0 1 0 0 0 0 0 0 0 0 0 0 0 0 0 0 1 0 0 0 0 0 0 0 0 0 0 0 0 0 0 1 0 0 0 0 0 0 0 0 0 0 0 0 
1 0 0 0 0 0 0 0 0 0 0 0 0 0 0 1 0 0 0 0 0 0 0 0 0 0 0 0 0 0 1 0 0 0 0 0 0 0 0 0 0 0 0 0 0 1 0 0 0 0 0 0 0 0 0 0 0 0 
1 0 0 0 0 0 0 0 0 0 0 0 0 0 0 1 0 0 0 0 0 0 0 0 0 0 0 0 0 0 1 0 0 0 0 0 0 0 0 0 0 0 0 0 0 1 0 0 0 0 0 0 0 0 0 0 0 0 
1 0 0 0 0 0 0 0 0 0 0 0 0 0 0 1 0 0 0 0 0 0 0 0 0 0 0 0 0 0 1 0 0 0 0 0 0 0 0 0 0 0 0 0 0 1 0 0 0 0 0 0 0 0 0 0 0 0 
1 0 0 0 0 0 0 2 2 2 2 0 0 0 0 1 0 0 0 0 0 0 2 2 2 2 0 0 0 0 1 0 0 0 0 0 0 2 2 2 2 0 0 0 0 1 0 0 0 0 0 0 2 2 2 2 0 0 
1 0 0 0 0 0 0 2 2 2 2 0 0 0 0 1 0 0 0 0 0 0 2 2 2 2 0 0 0 0 1 0 0 0 0 0 0 2 2 2 2 0 0 0 0 1 0 0 0 0 0 0 2 2 2 2 0 0 
1 0 0 0 0 0 0 2 2 2 2 0 0 0 0 1 0 0 0 0 0 0 2 2 2 2 0 0 0 0 1 0 0 0 0 0 0 2 2 2 2 0 0 0 0 1 0 0 0 0 0 0 2 2 2 2 0 0 
1 0 0 0 0 0 0 2 2 2 2 0 0 0 0 1 0 0 0 0 0 0 2 2 2 2 0 0 0 0 1 0 0 0 0 0 0 2 2 2 2 0 0 0 0 1 0 0 0 0 0 0 2 2 2 2 0 0 
1 0 1 1 1 1 1 1 1 1 1 1 1 1 1 1 0 1 1 1 1 1 1 1 1 1 1 1 1 1 1 0 1 1 1 1 1 1 1 1 1 1 1 1 1 1 0 1 1 1 1 1 1 1 1 1 1 1  
1 0 0 1 1 1 1 1 1 1 1 1 1 1 1 1 0 0 1 1 1 1 1 1 1 1 1 1 1 1 1 0 0 1 1 1 1 1 1 1 1 1 1 1 1 1 0 0 1 1 1 1 1 1 1 1 1 1 
1 0 0 0 0 0 0 0 0 0 0 0 0 0 0 1 0 0 0 0 0 0 0 0 0 0 0 0 0 0 1 0 0 0 0 0 0 0 0 0 0 0 0 0 0 1 0 0 0 0 0 0 0 0 0 0 0 0 
1 0 0 0 0 0 0 0 0 0 0 0 0 0 0 1 0 0 0 0 0 0 0 0 0 0 0 0 0 0 1 0 0 0 0 0 0 0 0 0 0 0 0 0 0 1 0 0 0 0 0 0 0 0 0 0 0 0 
1 0 0 0 0 0 0 0 0 0 0 0 0 0 0 1 0 0 0 0 0 0 0 0 0 0 0 0 0 0 1 0 0 0 0 0 0 0 0 0 0 0 0 0 0 1 0 0 0 0 0 0 0 0 0 0 0 0 
1 0 0 0 0 0 0 0 0 0 0 0 0 0 0 1 0 0 0 0 0 0 0 0 0 0 0 0 0 0 1 0 0 0 0 0 0 0 0 0 0 0 0 0 0 1 0 0 0 0 0 0 0 0 0 0 0 0 
1 0 0 0 0 0 0 0 0 0 0 0 0 0 0 1 0 0 0 0 0 0 0 0 0 0 0 0 0 0 1 0 0 0 0 0 0 0 0 0 0 0 0 0 0 1 0 0 0 0 0 0 0 0 0 0 0 0 
1 0 0 0 0 0 0 0 0 0 0 0 0 0 0 1 0 0 0 0 0 0 0 0 0 0 0 0 0 0 1 0 0 0 0 0 0 0 0 0 0 0 0 0 0 1 0 0 0 0 0 0 0 0 0 0 0 0 
1 0 0 0 0 0 0 2 2 2 2 0 0 0 0 1 0 0 0 0 0 0 2 2 2 2 0 0 0 0 1 0 0 0 0 0 0 2 2 2 2 0 0 0 0 1 0 0 0 0 0 0 2 2 2 2 0 0 
1 0 0 0 0 0 0 2 2 2 2 0 0 0 0 1 0 0 0 0 0 0 2 2 2 2 0 0 0 0 1 0 0 0 0 0 0 2 2 2 2 0 0 0 0 1 0 0 0 0 0 0 2 2 2 2 0 0 
1 0 0 0 0 0 0 2 2 2 2 0 0 0 0 1 0 0 0 0 0 0 2 2 2 2 0 0 0 0 1 0 0 0 0 0 0 2 2 2 2 0 0 0 0 1 0 0 0 0 0 0 2 2 2 2 0 0 
1 0 0 0 0 0 0 2 2 2 2 0 0 0 0 1 0 0 0 0 0 0 2 2 2 2 0 0 0 0 1 0 0 0 0 0 0 2 2 2 2 0 0 0 0 1 0 0 0 0 0 0 2 2 2 2 0 0 
1 0 1 1 1 1 1 1 1 1 1 1 1 1 1 1 0 1 1 1 1 1 1 1 1 1 1 1 1 1 1 0 1 1 1 1 1 1 1 1 1 1 1 1 1 1 0 1 1 1 1 1 1 1 1 1 1 1  
1 0 0 1 1 1 1 1 1 1 1 1 1 1 1 1 0 0 1 1 1 1 1 1 1 1 1 1 1 1 1 0 0 1 1 1 1 1 1 1 1 1 1 1 1 1 0 0 1 1 1 1 1 1 1 1 1 1 
1 0 0 0 0 0 0 0 0 0 0 0 0 0 0 1 0 0 0 0 0 0 0 0 0 0 0 0 0 0 1 0 0 0 0 0 0 0 0 0 0 0 0 0 0 1 0 0 0 0 0 0 0 0 0 0 0 0 
1 0 0 0 0 0 0 0 0 0 0 0 0 0 0 1 0 0 0 0 0 0 0 0 0 0 0 0 0 0 1 0 0 0 0 0 0 0 0 0 0 0 0 0 0 1 0 0 0 0 0 0 0 0 0 0 0 0 
1 0 0 0 0 0 0 0 0 0 0 0 0 0 0 1 0 0 0 0 0 0 0 0 0 0 0 0 0 0 1 0 0 0 0 0 0 0 0 0 0 0 0 0 0 1 0 0 0 0 0 0 0 0 0 0 0 0 
1 0 0 0 0 0 0 0 0 0 0 0 0 0 0 1 0 0 0 0 0 0 0 0 0 0 0 0 0 0 1 0 0 0 0 0 0 0 0 0 0 0 0 0 0 1 0 0 0 0 0 0 0 0 0 0 0 0 
1 0 0 0 0 0 0 0 0 0 0 0 0 0 0 1 0 0 0 0 0 0 0 0 0 0 0 0 0 0 1 0 0 0 0 0 0 0 0 0 0 0 0 0 0 1 0 0 0 0 0 0 0 0 0 0 0 0 
1 0 0 0 0 0 0 0 0 0 0 0 0 0 0 1 0 0 0 0 0 0 0 0 0 0 0 0 0 0 1 0 0 0 0 0 0 0 0 0 0 0 0 0 0 1 0 0 0 0 0 0 0 0 0 0 0 0 
1 0 0 0 0 0 0 2 2 2 2 0 0 0 0 1 0 0 0 0 0 0 2 2 2 2 0 0 0 0 1 0 0 0 0 0 0 2 2 2 2 0 0 0 0 1 0 0 0 0 0 0 2 2 2 2 0 0 
1 0 0 0 0 0 0 2 2 2 2 0 0 0 0 1 0 0 0 0 0 0 2 2 2 2 0 0 0 0 1 0 0 0 0 0 0 2 2 2 2 0 0 0 0 1 0 0 0 0 0 0 2 2 2 2 0 0 
1 0 0 0 0 0 0 2 2 2 2 0 0 0 0 1 0 0 0 0 0 0 2 2 2 2 0 0 0 0 1 0 0 0 0 0 0 2 2 2 2 0 0 0 0 1 0 0 0 0 0 0 2 2 2 2 0 0 
1 0 0 0 0 0 0 2 2 2 2 0 0 0 0 1 0 0 0 0 0 0 2 2 2 2 0 0 0 0 1 0 0 0 0 0 0 2 2 2 2 0 0 0 0 1 0 0 0 0 0 0 2 2 2 2 0 0 
1 0 1 1 1 1 1 1 1 1 1 1 1 1 1 1 0 1 1 1 1 1 1 1 1 1 1 1 1 1 1 0 1 1 1 1 1 1 1 1 1 1 1 1 1 1 0 1 1 1 1 1 1 1 1 1 1 1  
1 0 0 1 1 1 1 1 1 1 1 1 1 1 1 1 0 0 1 1 1 1 1 1 1 1 1 1 1 1 1 0 0 1 1 1 1 1 1 1 1 1 1 1 1 1 0 0 1 1 1 1 1 1 1 1 1 1 
1 0 0 0 0 0 0 0 0 0 0 0 0 0 0 1 0 0 0 0 0 0 0 0 0 0 0 0 0 0 1 0 0 0 0 0 0 0 0 0 0 0 0 0 0 1 0 0 0 0 0 0 0 0 0 0 0 0 
1 0 0 0 0 0 0 0 0 0 0 0 0 0 0 1 0 0 0 0 0 0 0 0 0 0 0 0 0 0 1 0 0 0 0 0 0 0 0 0 0 0 0 0 0 1 0 0 0 0 0 0 0 0 0 0 0 0 
1 0 0 0 0 0 0 0 0 0 0 0 0 0 0 1 0 0 0 0 0 0 0 0 0 0 0 0 0 0 1 0 0 0 0 0 0 0 0 0 0 0 0 0 0 1 0 0 0 0 0 0 0 0 0 0 0 0 
1 0 0 0 0 0 0 0 0 0 0 0 0 0 0 1 0 0 0 0 0 0 0 0 0 0 0 0 0 0 1 0 0 0 0 0 0 0 0 0 0 0 0 0 0 1 0 0 0 0 0 0 0 0 0 0 0 0 
1 0 0 0 0 0 0 0 0 0 0 0 0 0 0 1 0 0 0 0 0 0 0 0 0 0 0 0 0 0 1 0 0 0 0 0 0 0 0 0 0 0 0 0 0 1 0 0 0 0 0 0 0 0 0 0 0 0 
1 0 0 0 0 0 0 0 0 0 0 0 0 0 0 1 0 0 0 0 0 0 0 0 0 0 0 0 0 0 1 0 0 0 0 0 0 0 0 0 0 0 0 0 0 1 0 0 0 0 0 0 0 0 0 0 0 0 
1 0 0 0 0 0 0 2 2 2 2 0 0 0 0 1 0 0 0 0 0 0 2 2 2 2 0 0 0 0 1 0 0 0 0 0 0 2 2 2 2 0 0 0 0 1 0 0 0 0 0 0 2 2 2 2 0 0 
1 0 0 0 0 0 0 2 2 2 2 0 0 0 0 1 0 0 0 0 0 0 2 2 2 2 0 0 0 0 1 0 0 0 0 0 0 2 2 2 2 0 0 0 0 1 0 0 0 0 0 0 2 2 2 2 0 0 
1 0 0 0 0 0 0 2 2 2 2 0 0 0 0 1 0 0 0 0 0 0 2 2 2 2 0 0 0 0 1 0 0 0 0 0 0 2 2 2 2 0 0 0 0 1 0 0 0 0 0 0 2 2 2 2 0 0 
1 0 0 0 0 0 0 2 2 2 2 0 0 0 0 1 0 0 0 0 0 0 2 2 2 2 0 0 0 0 1 0 0 0 0 0 0 2 2 2 2 0 0 0 0 1 0 0 0 0 0 0 2 2 2 2 0 0 
1 0 1 1 1 1 1 1 1 1 1 1 1 1 1 1 0 1 1 1 1 1 1 1 1 1 1 1 1 1 1 0 1 1 1 1 1 1 1 1 1 1 1 1 1 1 0 1 1 1 1 1 1 1 1 1 1 1  
