198 198 198 198 198 198 198 198 198 198 198 198 198 198 198 198 198 198 198 198 198 198 198 198 198 198 198 198 198 198 198 198 198 198 198 198 198 198 198 198 198 198 198 198 198 198 198 198 198 198 
198 198 198 198 198 198 198 198 198 199 198 198 198 198 198 198 198 198 198 198 198 198 198 198 198 198 198 198 198 198 198 198 198 198 198 198 198 198 198 198 198 198 198 198 198 198 198 198 198 198 
198 198 198 198 198 198 198 198 198 198 198 198 198 198 198 198 198 198 198 198 198 198 198 198 198 198 198 198 198 198 198 198 198 198 198 198 198 198 198 198 198 198 198 198 198 198 198 198 198 198 
198 198 198 199 198 198 198 198 198 198 198 198 198 198 198 198 198 198 198 198 198 198 198 198 198 198 198 199 198 198 198 198 198 198 198 199 198 198 198 198 198 198 198 198 198 198 198 198 198 198 
198 198 198 198 198 198 199 198 198 198 198 198 198 198 198 198 198 199 198 198 198 198 199 198 198 198 198 198 198 198 198 198 198 198 198 198 198 198 198 198 198 198 198 198 198 198 198 198 198 198 
198 198 198 198 198 198 198 198 198 198 198 198 199 198 198 198 198 198 198 198 198 198 198 198 198 198 198 198 198 199 198 199 198 198 198 198 198 198 198 198 198 198 198 198 198 198 198 198 198 198 
198 198 198 198 198 198 198 198 208 206 206 206 206 206 206 206 209 198 208 206 206 206 206 206 206 206 206 209 198 198 198 208 206 206 206 206 206 206 206 206 206 206 209 198 198 198 198 198 198 198 
198 199 198 198 198 198 198 198 204 195 32 32 32 32 32 195 205 206 207 195 186 186 186 186 186 186 186 205 206 206 206 207 196 186 190 188 188 188 188 188 188 191 203 198 198 199 198 198 198 198 
198 198 198 198 198 198 198 198 204 195 32 17 17 17 32 195 195 195 195 195 186 200 201 201 201 202 186 196 196 196 196 196 196 196 185 180 180 180 180 180 180 184 203 198 198 198 198 198 198 198 
198 198 198 198 198 198 198 198 204 195 32 17 36 17 32 195 195 195 195 195 186 203 198 198 198 204 186 196 196 196 196 196 196 196 185 180 180 180 180 180 180 184 203 198 198 198 198 199 198 198 
198 198 198 198 198 198 198 198 204 195 32 17 17 17 32 195 195 195 195 195 186 203 198 198 198 204 186 196 196 196 196 196 196 196 185 180 180 180 180 180 180 184 203 199 198 198 198 198 198 198 
198 198 199 198 198 198 198 198 204 195 32 17 17 17 32 195 195 195 195 195 186 205 206 206 206 207 186 196 196 196 196 196 196 196 185 180 180 180 180 180 180 184 203 198 198 198 198 198 198 198 
198 198 198 198 198 199 198 198 204 195 32 32 17 32 32 195 195 195 195 195 186 186 190 188 191 186 186 186 186 186 186 186 186 186 192 182 182 183 180 181 182 193 203 198 198 198 198 198 198 198 
198 198 198 198 198 198 198 198 204 195 195 195 186 195 195 195 195 195 195 195 195 195 185 180 184 196 196 196 196 196 196 196 196 196 196 196 196 185 180 184 200 201 211 198 198 198 199 198 198 198 
198 198 198 198 198 198 198 198 210 202 195 195 186 195 195 195 195 195 195 195 195 195 185 180 184 196 196 196 196 196 196 196 196 196 196 196 196 185 180 184 203 198 198 198 198 198 198 198 198 198 
198 199 198 198 198 198 198 199 198 204 195 195 186 195 195 195 195 195 195 195 195 195 185 180 184 196 196 196 196 196 196 196 196 196 196 196 196 185 180 184 203 199 198 198 198 198 198 198 198 198 
198 198 198 198 198 198 198 198 208 207 195 195 186 195 195 195 195 195 195 195 195 195 185 180 184 186 186 186 196 196 196 196 196 196 196 196 196 185 180 184 203 198 198 199 198 198 198 198 198 198 
198 198 198 198 198 198 198 208 207 194 195 195 186 195 195 195 195 195 195 195 195 195 185 180 184 196 196 196 196 196 196 196 196 196 196 190 188 189 180 184 203 198 198 198 198 198 198 198 198 198 
198 198 198 198 198 198 198 204 194 194 186 186 186 195 195 195 195 195 195 195 195 195 185 180 184 196 196 196 196 196 196 196 196 196 196 185 180 180 180 184 203 198 198 198 198 198 199 198 198 198 
198 198 198 198 198 199 198 204 194 194 186 194 194 195 195 195 195 195 195 195 195 186 185 180 184 186 196 196 196 196 196 196 196 196 196 185 180 181 182 193 203 198 198 198 198 198 198 198 198 198 
198 198 198 198 198 198 198 204 194 194 186 194 194 186 190 188 188 188 188 188 188 188 189 180 187 188 188 188 188 191 196 196 196 190 188 189 180 184 186 196 203 198 198 199 198 198 198 198 198 198 
198 198 198 199 198 198 198 204 194 194 186 194 194 186 185 180 180 180 180 180 180 180 180 180 180 180 180 180 180 184 186 186 186 185 180 180 180 184 186 200 211 198 198 198 198 198 198 198 198 198 
198 198 198 198 198 198 198 204 194 194 186 194 194 186 192 182 182 182 182 182 182 182 183 180 181 182 182 182 182 193 195 195 195 192 182 183 180 184 179 203 198 198 199 198 198 198 198 198 198 198 
198 198 198 198 198 198 198 210 202 194 186 194 194 186 194 194 194 194 194 194 194 186 185 180 184 186 195 195 195 195 195 195 195 195 195 185 180 184 186 203 198 198 198 198 198 198 198 198 198 198 
198 198 198 198 198 198 198 198 204 194 186 194 194 186 194 194 194 194 194 194 194 194 185 180 184 195 195 195 195 195 195 195 195 195 195 185 180 184 186 203 198 198 198 198 198 198 198 198 198 198 
198 198 198 198 198 198 198 208 207 194 186 194 194 186 186 194 194 194 194 194 194 194 185 180 184 195 195 195 195 195 195 195 195 195 195 185 180 184 186 203 198 198 198 198 198 198 199 198 198 198 
198 198 198 199 198 198 198 204 194 194 186 194 194 194 186 194 194 194 194 194 194 194 185 180 184 195 195 195 195 195 195 195 195 195 195 185 180 184 186 203 198 198 198 198 198 198 198 198 198 198 
198 198 198 198 198 198 198 204 194 194 186 194 194 194 186 194 194 194 194 194 194 194 185 180 184 186 186 186 195 195 195 195 195 195 195 185 180 184 186 203 198 198 198 198 198 198 198 198 198 198 
198 198 198 198 198 198 198 204 194 194 186 194 194 194 186 194 194 194 194 194 194 194 185 180 184 195 195 186 195 195 195 195 195 195 195 185 180 184 186 203 198 198 199 198 198 198 198 198 198 198 
198 198 199 198 198 198 198 204 194 194 186 186 186 186 186 186 194 194 194 194 194 194 185 180 184 195 195 186 195 195 186 195 195 195 195 192 182 193 186 203 198 198 198 198 198 198 198 198 198 198 
198 198 198 198 198 198 198 204 194 194 186 179 186 186 186 186 194 194 194 194 194 194 185 180 184 195 195 186 195 195 186 195 195 195 195 195 186 195 200 211 198 198 198 198 198 198 198 198 198 198 
198 198 198 198 198 198 199 210 202 194 186 186 186 186 186 186 194 194 194 194 194 194 185 180 184 195 195 186 186 186 186 195 195 195 195 195 186 186 203 198 199 198 198 198 198 198 198 198 198 198 
198 198 198 198 198 198 198 198 204 194 186 186 186 179 186 186 194 194 194 194 194 194 185 180 184 195 195 195 195 195 195 195 195 195 195 186 186 186 203 198 198 198 198 198 198 198 198 199 198 198 
198 198 198 198 198 198 198 198 204 194 186 186 186 186 186 186 194 194 194 194 194 194 185 180 184 195 195 195 195 195 195 195 195 195 195 186 186 179 203 198 198 198 198 198 198 198 198 198 198 198 
198 198 198 198 199 198 198 198 204 194 186 186 186 186 186 186 194 194 194 194 194 194 185 180 184 195 195 195 195 195 195 195 195 195 195 186 186 186 203 198 198 198 198 198 198 198 198 198 198 198 
198 198 198 198 198 198 198 208 207 194 194 194 194 194 194 194 194 194 194 194 194 194 192 182 193 195 195 195 195 195 195 195 195 195 195 186 186 186 205 209 198 198 198 198 198 198 198 198 198 198 
198 198 198 198 198 198 198 204 194 194 194 194 194 194 194 194 194 194 194 194 186 186 186 186 186 186 186 195 195 195 195 195 195 195 186 186 186 186 186 205 209 198 198 199 198 198 198 198 198 198 
198 198 198 198 198 198 198 204 194 194 194 194 194 194 194 194 194 194 194 186 186 186 186 179 186 186 186 186 195 195 186 195 195 186 186 179 186 186 186 186 203 198 198 198 198 198 198 198 198 198 
198 198 198 198 198 198 198 204 194 194 194 194 194 194 194 194 194 194 194 186 186 186 186 186 186 186 186 186 195 195 195 195 186 186 186 186 186 186 186 186 203 198 198 198 198 198 198 198 198 198 
198 198 198 198 198 198 198 204 194 194 212 194 194 194 194 194 194 194 194 186 186 186 186 186 186 186 179 186 186 195 195 195 186 186 186 186 186 196 186 179 203 198 198 198 198 198 198 198 198 198 
198 198 198 198 198 199 198 204 194 194 186 194 194 186 186 186 186 186 186 186 179 186 186 186 186 186 186 186 186 186 186 186 186 186 196 186 186 186 186 186 203 198 198 198 198 198 198 198 198 198 
198 198 198 198 198 198 198 204 194 194 186 186 186 186 194 200 201 201 202 186 186 186 186 186 186 186 186 200 201 201 202 186 186 186 186 186 186 186 186 186 203 198 198 198 198 198 198 198 198 198 
198 199 198 198 198 198 198 204 194 194 194 194 194 194 200 211 198 198 210 202 186 186 186 186 186 186 200 211 198 198 204 186 186 196 186 186 196 186 186 186 203 198 198 198 198 198 199 198 198 198 
198 198 198 198 198 198 198 210 201 201 201 201 201 201 211 198 198 198 198 210 201 201 201 201 201 201 211 198 198 198 210 202 186 186 186 186 186 186 200 201 211 198 199 198 198 198 198 198 198 198 
198 198 198 198 198 198 198 198 198 198 198 198 198 198 199 198 198 198 198 198 198 198 198 198 198 198 198 198 199 198 198 210 201 201 201 201 201 201 211 198 198 198 198 198 198 198 198 198 198 198 
198 198 198 198 199 198 198 198 198 198 198 198 198 198 198 198 198 198 198 198 198 198 198 198 198 198 198 198 198 198 198 198 199 198 198 198 198 198 198 199 198 198 198 198 198 198 198 198 198 198 
198 198 198 198 198 198 198 198 198 199 198 198 198 198 198 198 198 198 198 198 198 198 198 199 198 198 198 198 198 198 198 198 198 198 198 198 198 198 198 198 198 198 198 198 198 199 198 198 198 198 
198 198 198 198 198 198 198 198 198 198 198 198 198 198 198 198 198 198 198 198 198 198 198 198 198 198 198 198 198 198 198 198 198 198 198 198 198 198 198 198 198 198 198 198 198 198 198 198 198 198 
198 198 198 198 198 198 198 198 198 198 198 198 198 198 198 198 198 198 198 198 198 198 198 198 198 198 198 198 198 198 198 198 198 198 198 198 198 198 198 198 198 198 198 198 198 198 198 198 198 198 
198 198 198 198 198 198 198 198 198 198 198 198 198 198 198 198 198 198 198 198 198 198 198 198 198 198 198 198 198 198 198 198 198 198 198 198 198 198 198 198 198 198 198 198 198 198 198 198 198 198 