246 246 246 246 246 246 246 246 246 246 246 246 246 246 246 246 246 246 246 246 246 246 246 246 246 246 246 246 246 246 246 246 246 246 246 246 246 246 246 246 246 246 246 246 246 246 246 246 246 246 
246 246 246 246 246 246 246 246 246 174 246 246 246 246 246 246 246 246 246 246 246 246 246 246 246 246 246 246 246 246 246 246 246 246 246 246 246 246 246 246 246 246 246 246 246 246 246 246 246 246 
246 246 246 246 246 246 246 246 246 246 246 246 246 246 246 246 246 246 246 246 246 246 246 246 246 246 246 246 246 246 246 246 246 246 246 246 246 246 246 246 246 246 246 246 246 246 246 246 246 246 
246 246 246 174 246 246 246 246 246 246 246 246 246 246 246 246 246 246 246 246 246 246 246 246 246 246 246 174 246 246 246 246 246 246 246 174 246 246 246 246 246 246 246 246 246 246 246 246 246 246 
246 246 246 246 246 246 174 246 246 246 246 246 246 246 246 246 246 174 246 246 246 246 174 246 246 246 246 246 246 246 246 246 246 246 246 246 246 246 246 246 246 246 246 246 246 246 246 246 246 246 
246 246 246 246 246 246 246 246 246 246 246 246 174 246 246 246 246 246 246 246 246 246 246 246 246 246 246 246 246 174 246 174 246 246 246 246 246 246 246 246 246 246 246 246 246 246 246 246 246 246 
246 246 246 246 246 246 246 246 167 165 165 165 165 165 165 165 168 246 167 165 165 165 165 165 165 165 165 168 246 246 246 167 165 165 165 165 165 165 165 165 165 165 168 246 246 246 246 246 246 246 
246 174 246 246 246 246 246 246 163 177 32 32 32 32 32 173 164 165 166 173 144 144 144 144 144 144 144 164 165 165 165 166 173 144 155 153 153 153 153 153 153 156 162 246 246 174 246 246 246 246 
246 246 246 246 246 246 246 246 163 177 32 17 17 17 32 173 173 173 173 173 144 159 160 160 160 161 144 173 173 173 173 173 173 173 151 146 146 146 146 146 146 150 162 246 246 246 246 246 246 246 
246 246 246 246 246 246 246 246 163 177 32 17 36 17 32 173 173 173 173 173 144 162 246 246 246 163 144 173 173 173 173 173 173 173 151 146 146 146 146 146 146 150 162 246 246 246 246 174 246 246 
246 246 246 246 246 246 246 246 163 177 32 17 17 17 32 173 173 173 173 173 144 162 246 246 246 163 144 173 173 173 173 173 173 173 151 146 146 146 146 146 146 150 162 174 246 246 246 246 246 246 
246 246 174 246 246 246 246 246 163 177 32 17 17 17 32 173 173 173 173 173 144 164 165 165 165 166 144 173 173 173 173 173 173 173 151 146 146 146 146 146 146 150 162 246 246 246 246 246 246 246 
246 246 246 246 246 174 246 246 163 177 32 32 17 32 32 173 173 173 173 173 144 144 155 153 156 144 144 144 144 144 144 144 144 144 157 148 148 149 146 147 148 158 162 246 246 246 246 246 246 246 
246 246 246 246 246 246 246 246 163 177 177 177 144 177 177 177 177 177 177 177 177 177 151 146 150 177 177 177 177 177 177 177 177 177 177 177 177 151 146 150 159 160 170 246 246 246 174 246 246 246 
246 246 246 246 246 246 246 246 169 161 177 177 144 177 177 177 177 177 177 177 177 177 151 146 150 177 177 177 177 177 177 177 177 177 177 177 177 151 146 150 162 246 246 246 246 246 246 246 246 246 
246 174 246 246 246 246 246 174 246 163 177 177 144 177 177 177 177 177 177 177 177 177 151 146 150 177 177 177 177 177 177 177 177 177 177 177 177 151 146 150 162 174 246 246 246 246 246 246 246 246 
246 246 246 246 246 246 246 246 167 166 177 177 144 177 177 177 177 177 177 177 177 177 151 146 150 144 144 144 177 177 177 177 177 177 177 177 177 151 146 150 162 246 246 174 246 246 246 246 246 246 
246 246 246 246 246 246 246 167 166 177 177 177 144 177 177 177 177 177 177 177 177 177 151 146 150 177 177 177 177 177 177 177 177 177 177 155 153 154 146 150 162 246 246 246 246 246 246 246 246 246 
246 246 246 246 246 246 246 163 177 177 144 144 144 177 177 177 177 177 177 177 177 177 151 146 150 177 177 177 177 177 177 177 177 177 177 151 146 146 146 150 162 246 246 246 246 246 174 246 246 246 
246 246 246 246 246 174 246 163 177 177 144 177 177 177 177 177 177 177 177 177 177 144 151 146 150 144 177 177 177 177 177 177 177 177 177 151 146 147 148 158 162 246 246 246 246 246 246 246 246 246 
246 246 246 246 246 246 246 163 177 177 144 177 177 144 155 153 153 153 153 153 153 153 154 146 152 153 153 153 153 156 177 177 177 155 153 154 146 150 144 177 162 246 246 174 246 246 246 246 246 246 
246 246 246 174 246 246 246 163 177 177 144 177 177 144 151 146 146 146 146 146 146 146 146 146 146 146 146 146 146 150 144 144 144 151 146 146 146 150 144 159 170 246 246 246 246 246 246 246 246 246 
246 246 246 246 246 246 246 163 177 177 144 177 177 144 157 148 148 148 148 148 148 148 149 146 147 148 148 148 148 158 175 175 175 157 148 149 146 150 145 162 246 246 174 246 246 246 246 246 246 246 
246 246 246 246 246 246 246 169 161 177 144 177 177 144 177 177 177 177 177 177 177 144 151 146 150 144 175 175 175 175 175 175 175 175 175 151 146 150 144 162 246 246 246 246 246 246 246 246 246 246 
246 246 246 246 246 246 246 246 163 177 144 177 177 144 177 177 177 177 177 177 177 177 151 146 150 175 175 175 175 175 175 175 175 175 175 151 146 150 144 162 246 246 246 246 246 246 246 246 246 246 
246 246 246 246 246 246 246 167 166 177 144 177 177 144 144 177 177 177 177 177 177 177 151 146 150 175 175 175 175 175 175 175 175 175 175 151 146 150 144 162 246 246 246 246 246 246 174 246 246 246 
246 246 246 174 246 246 246 163 177 177 144 177 177 177 144 177 177 177 177 177 177 177 151 146 150 175 175 175 175 175 175 175 175 175 175 151 146 150 144 162 246 246 246 246 246 246 246 246 246 246 
246 246 246 246 246 246 246 163 177 177 144 177 177 177 144 177 177 177 177 177 177 177 151 146 150 144 144 144 175 175 175 175 175 175 175 151 146 150 144 162 246 246 246 246 246 246 246 246 246 246 
246 246 246 246 246 246 246 163 177 177 144 177 177 177 144 177 177 177 177 177 177 177 151 146 150 175 175 144 175 175 175 175 175 175 175 151 146 150 144 162 246 246 174 246 246 246 246 246 246 246 
246 246 174 246 246 246 246 163 177 177 144 144 144 144 144 144 177 177 177 177 177 177 151 146 150 175 175 144 175 175 144 175 175 175 175 157 148 158 144 162 246 246 246 246 246 246 246 246 246 246 
246 246 246 246 246 246 246 163 177 177 144 145 144 144 144 144 177 177 177 177 177 177 151 146 150 175 175 144 175 175 144 175 175 175 175 175 144 175 159 170 246 246 246 246 246 246 246 246 246 246 
246 246 246 246 246 246 174 169 161 177 144 144 144 144 144 144 177 177 177 177 177 177 151 146 150 175 175 144 144 144 144 175 175 175 175 175 144 144 162 246 174 246 246 246 246 246 246 246 246 246 
246 246 246 246 246 246 246 246 163 177 144 144 144 145 144 144 177 177 177 177 177 177 151 146 150 175 175 175 175 175 175 175 175 175 175 144 144 144 162 246 246 246 246 246 246 246 246 174 246 246 
246 246 246 246 246 246 246 246 163 177 144 144 144 144 144 144 177 177 177 177 177 177 151 146 150 175 175 175 175 175 175 175 175 175 175 144 144 145 162 246 246 246 246 246 246 246 246 246 246 246 
246 246 246 246 174 246 246 246 163 177 144 144 144 144 144 144 177 177 177 177 177 177 151 146 150 175 175 175 175 175 175 175 175 175 175 144 144 144 162 246 246 246 246 246 246 246 246 246 246 246 
246 246 246 246 246 246 246 167 166 177 177 177 177 177 177 177 177 177 177 177 177 177 157 148 158 175 175 175 175 175 175 175 175 175 175 144 144 144 164 168 246 246 246 246 246 246 246 246 246 246 
246 246 246 246 246 246 246 163 177 177 177 177 177 177 177 177 177 177 177 177 144 144 144 144 144 144 144 175 175 175 175 175 175 175 144 144 144 144 144 164 168 246 246 174 246 246 246 246 246 246 
246 246 246 246 246 246 246 163 177 177 177 177 177 177 177 177 177 177 177 144 144 144 144 145 144 144 144 144 175 175 144 175 175 144 144 145 144 144 144 144 162 246 246 246 246 246 246 246 246 246 
246 246 246 246 246 246 246 163 177 177 177 177 177 177 177 177 177 177 177 144 144 144 144 144 144 144 144 144 175 175 175 175 144 144 144 144 144 144 144 144 162 246 246 246 246 246 246 246 246 246 
246 246 246 246 246 246 246 163 177 177 171 177 177 177 177 177 177 177 177 144 144 144 144 144 144 144 145 144 144 175 175 175 144 144 144 144 144 177 144 145 162 246 246 246 246 246 246 246 246 246 
246 246 246 246 246 174 246 163 177 177 144 177 177 144 144 144 144 144 144 144 145 144 144 144 144 144 144 144 144 144 144 144 144 144 177 144 144 144 144 144 162 246 246 246 246 246 246 246 246 246 
246 246 246 246 246 246 246 163 177 177 144 144 144 144 177 159 160 160 161 144 144 144 144 144 144 144 144 159 160 160 161 144 144 144 144 144 144 144 144 144 162 246 246 246 246 246 246 246 246 246 
246 174 246 246 246 246 246 163 177 177 177 177 177 177 159 170 246 246 169 161 144 144 144 144 144 144 159 170 246 246 163 144 144 177 144 144 177 144 144 144 162 246 246 246 246 246 174 246 246 246 
246 246 246 246 246 246 246 169 160 160 160 160 160 160 170 246 246 246 246 169 160 160 160 160 160 160 170 246 246 246 169 161 144 144 144 144 144 144 159 160 170 246 174 246 246 246 246 246 246 246 
246 246 246 246 246 246 246 246 246 246 246 246 246 246 174 246 246 246 246 246 246 246 246 246 246 246 246 246 174 246 246 169 160 160 160 160 160 160 170 246 246 246 246 246 246 246 246 246 246 246 
246 246 246 246 174 246 246 246 246 246 246 246 246 246 246 246 246 246 246 246 246 246 246 246 246 246 246 246 246 246 246 246 174 246 246 246 246 246 246 174 246 246 246 246 246 246 246 246 246 246 
246 246 246 246 246 246 246 246 246 174 246 246 246 246 246 246 246 246 246 246 246 246 246 174 246 246 246 246 246 246 246 246 246 246 246 246 246 246 246 246 246 246 246 246 246 174 246 246 246 246 
246 246 246 246 246 246 246 246 246 246 246 246 246 246 246 246 246 246 246 246 246 246 246 246 246 246 246 246 246 246 246 246 246 246 246 246 246 246 246 246 246 246 246 246 246 246 246 246 246 246 
246 246 246 246 246 246 246 246 246 246 246 246 246 246 246 246 246 246 246 246 246 246 246 246 246 246 246 246 246 246 246 246 246 246 246 246 246 246 246 246 246 246 246 246 246 246 246 246 246 246 
246 246 246 246 246 246 246 246 246 246 246 246 246 246 246 246 246 246 246 246 246 246 246 246 246 246 246 246 246 246 246 246 246 246 246 246 246 246 246 246 246 246 246 246 246 246 246 246 246 246 