56 56 56 56 56 56 56 56 56 56 56 56 56 56 56 56 56 56 56 56 56 56 56 56 56 56 56 56 56 56 56 56 56 56 56 56 56 56 56 56 56 56 56 56 56 56 56 56 56 56 
56 56 56 56 56 56 56 56 56 57 56 56 56 56 56 56 56 56 56 56 56 56 56 56 56 56 56 56 56 56 56 56 56 56 56 56 56 56 56 56 56 56 56 56 56 56 56 56 56 56 
56 56 56 56 56 56 56 56 56 56 56 56 56 56 56 56 56 56 56 56 56 56 56 56 56 56 56 56 56 56 56 56 56 56 56 56 56 56 56 56 56 56 56 56 56 56 56 56 56 56 
56 56 56 57 56 56 56 56 56 56 56 56 56 56 56 56 56 56 56 56 56 56 56 56 56 56 56 57 56 56 56 56 56 56 56 57 56 56 56 56 56 56 56 56 56 56 56 56 56 56 
56 56 56 56 56 56 57 56 56 56 56 56 56 56 56 56 56 57 56 56 56 56 57 56 56 56 56 56 56 56 56 56 56 56 56 56 56 56 56 56 56 56 56 56 56 56 56 56 56 56 
56 56 56 56 56 56 56 56 56 56 56 56 57 56 56 56 56 56 56 56 56 56 56 56 56 56 56 56 56 57 56 57 56 56 56 56 56 56 56 56 56 56 56 56 56 56 56 56 56 56 
56 56 56 56 56 56 56 56 66 64 64 64 64 64 64 64 67 56 66 64 64 64 64 64 64 64 64 67 56 56 56 66 64 64 64 64 64 64 64 64 64 64 67 56 56 56 56 56 56 56 
56 57 56 56 56 56 56 56 62 175 32 32 32 32 32 175 63 64 65 175 50 50 50 50 50 50 50 63 64 64 64 65 175 50 46 44 44 44 44 44 44 47 61 56 56 57 56 56 56 56 
56 56 56 56 56 56 56 56 62 175 32 17 17 17 32 175 175 175 175 175 50 58 59 59 59 60 50 175 175 175 175 175 175 175 42 55 55 55 55 55 55 41 61 56 56 56 56 56 56 56 
56 56 56 56 56 56 56 56 62 175 32 17 36 17 32 175 175 175 175 175 50 61 56 56 56 62 50 175 175 175 175 175 175 175 42 55 55 55 55 55 55 41 61 56 56 56 56 57 56 56 
56 56 56 56 56 56 56 56 62 175 32 17 17 17 32 175 175 175 175 175 50 61 56 56 56 62 50 175 175 175 175 175 175 175 42 55 55 55 55 55 55 41 61 57 56 56 56 56 56 56 
56 56 57 56 56 56 56 56 62 175 32 17 17 17 32 175 175 175 175 175 50 63 64 64 64 65 50 175 175 175 175 175 175 175 42 55 55 55 55 55 55 41 61 56 56 56 56 56 56 56 
56 56 56 56 56 57 56 56 62 175 32 32 17 32 32 175 175 175 175 175 50 50 46 44 47 50 50 50 50 50 50 50 50 50 48 39 39 40 55 38 39 49 61 56 56 56 56 56 56 56 
56 56 56 56 56 56 56 56 62 175 175 175 50 175 175 175 175 175 175 175 175 175 42 55 41 175 175 175 175 175 175 175 175 175 175 175 175 42 55 41 58 59 69 56 56 56 57 56 56 56 
56 56 56 56 56 56 56 56 68 60 175 175 50 175 175 175 175 175 175 175 175 175 42 55 41 175 175 175 175 175 175 175 175 175 175 175 175 42 55 41 61 56 56 56 56 56 56 56 56 56 
56 57 56 56 56 56 56 57 56 62 175 175 50 175 175 175 175 175 175 175 175 175 42 55 41 175 175 175 175 175 175 175 175 175 175 175 175 42 55 41 61 57 56 56 56 56 56 56 56 56 
56 56 56 56 56 56 56 56 66 65 175 175 50 175 175 175 175 175 175 175 175 175 42 55 41 50 50 50 175 175 175 175 175 175 175 175 175 42 55 41 61 56 56 57 56 56 56 56 56 56 
56 56 56 56 56 56 56 66 65 175 175 175 50 175 175 175 175 175 175 175 175 175 42 55 41 175 175 175 175 175 175 175 175 175 175 175 44 45 55 41 61 56 56 56 56 56 56 56 56 56 
56 56 56 56 56 56 56 62 175 175 50 50 50 175 175 175 175 175 175 175 175 175 42 55 41 175 175 175 175 175 175 175 175 175 175 42 55 55 55 41 61 56 56 56 56 56 57 56 56 56 
56 56 56 56 56 57 56 62 175 175 50 175 175 175 175 175 175 175 175 175 175 50 42 55 41 50 175 175 175 175 175 175 175 175 175 42 55 38 39 49 61 56 56 56 56 56 56 56 56 56 
56 56 56 56 56 56 56 62 175 175 50 175 175 50 46 44 44 44 44 44 44 44 45 55 43 44 44 44 44 47 175 175 175 46 44 45 55 41 50 175 61 56 56 57 56 56 56 56 56 56 
56 56 56 57 56 56 56 62 175 175 50 175 175 50 42 55 55 55 55 55 55 55 55 55 55 55 55 55 55 41 50 50 50 42 55 55 55 41 50 58 69 56 56 56 56 56 56 56 56 56 
56 56 56 56 56 56 56 62 175 175 50 175 175 50 48 39 39 39 39 39 39 39 40 55 38 39 39 39 39 49 175 175 175 48 39 40 55 41 51 61 56 56 57 56 56 56 56 56 56 56 
56 56 56 56 56 56 56 68 60 175 50 175 175 50 175 175 175 175 175 175 175 50 42 55 41 50 175 175 175 175 175 175 175 175 175 42 55 41 50 61 56 56 56 56 56 56 56 56 56 56 
56 56 56 56 56 56 56 56 62 175 50 175 175 50 175 175 175 175 175 175 175 175 42 55 41 175 175 175 175 175 175 175 175 175 175 42 55 41 50 61 56 56 56 56 56 56 56 56 56 56 
56 56 56 56 56 56 56 66 65 175 50 175 175 50 50 175 175 175 175 175 175 175 42 55 41 175 175 175 175 175 175 175 175 175 175 42 55 41 50 61 56 56 56 56 56 56 57 56 56 56 
56 56 56 57 56 56 56 62 175 175 50 175 175 175 50 175 175 175 175 175 175 175 42 55 41 175 175 175 175 175 175 175 175 175 175 42 55 41 50 61 56 56 56 56 56 56 56 56 56 56 
56 56 56 56 56 56 56 62 175 175 50 175 175 175 50 175 175 175 175 175 175 175 42 55 41 50 50 50 175 175 175 175 175 175 175 42 55 41 50 61 56 56 56 56 56 56 56 56 56 56 
56 56 56 56 56 56 56 62 175 175 50 175 175 175 50 175 175 175 175 175 175 175 42 55 41 175 175 50 175 175 175 175 175 175 175 42 55 41 50 61 56 56 57 56 56 56 56 56 56 56 
56 56 57 56 56 56 56 62 175 175 50 50 50 50 50 50 175 175 175 175 175 175 42 55 41 175 175 50 175 175 50 175 175 175 175 48 39 49 50 61 56 56 56 56 56 56 56 56 56 56 
56 56 56 56 56 56 56 62 175 175 50 51 50 50 50 50 175 175 175 175 175 175 42 55 41 175 175 50 175 175 50 175 175 175 175 175 50 175 58 69 56 56 56 56 56 56 56 56 56 56 
56 56 56 56 56 56 57 68 60 175 50 50 50 50 50 50 175 175 175 175 175 175 42 55 41 175 175 50 50 50 50 175 175 175 175 175 50 50 61 56 57 56 56 56 56 56 56 56 56 56 
56 56 56 56 56 56 56 56 62 175 50 50 50 51 50 50 175 175 175 175 175 175 42 55 41 175 175 175 175 175 175 175 175 175 175 50 50 50 61 56 56 56 56 56 56 56 56 57 56 56 
56 56 56 56 56 56 56 56 62 175 50 50 50 50 50 50 175 175 175 175 175 175 42 55 41 175 175 175 175 175 175 175 175 175 175 50 50 51 61 56 56 56 56 56 56 56 56 56 56 56 
56 56 56 56 57 56 56 56 62 175 50 50 50 50 50 50 175 175 175 175 175 175 42 55 41 175 175 175 175 175 175 175 175 175 175 50 50 50 61 56 56 56 56 56 56 56 56 56 56 56 
56 56 56 56 56 56 56 66 65 175 175 175 175 175 175 175 175 175 175 175 175 175 48 39 49 175 175 175 175 175 175 175 175 175 175 50 50 50 63 67 56 56 56 56 56 56 56 56 56 56 
56 56 56 56 56 56 56 62 175 175 175 175 175 175 175 175 175 175 175 175 50 50 50 50 50 50 50 175 175 175 175 175 175 175 50 50 50 50 50 63 67 56 56 57 56 56 56 56 56 56 
56 56 56 56 56 56 56 62 175 175 175 175 175 175 175 175 175 175 175 50 50 50 50 51 50 50 50 50 175 175 50 175 175 50 50 51 50 50 50 50 61 56 56 56 56 56 56 56 56 56 
56 56 56 56 56 56 56 62 175 175 175 175 175 175 175 175 175 175 175 50 50 50 50 50 50 50 50 50 175 175 175 175 50 50 50 50 50 50 50 50 61 56 56 56 56 56 56 56 56 56 
56 56 56 56 56 56 56 62 175 175 70 175 175 175 175 175 175 175 175 50 50 50 50 50 50 50 51 50 50 175 175 175 50 50 50 50 50 175 50 51 61 56 56 56 56 56 56 56 56 56 
56 56 56 56 56 57 56 62 175 175 50 175 175 50 50 50 50 50 50 50 51 50 50 50 50 50 50 50 50 50 50 50 50 50 175 50 50 50 50 50 61 56 56 56 56 56 56 56 56 56 
56 56 56 56 56 56 56 62 175 175 50 50 50 50 175 58 59 59 60 50 50 50 50 70 50 50 50 58 59 59 60 50 50 50 50 50 50 50 50 50 61 56 56 56 56 56 56 56 56 56 
56 57 56 56 56 56 56 62 175 175 175 175 175 175 58 69 56 56 68 60 50 50 50 50 50 50 58 69 56 56 62 50 50 175 50 50 175 50 50 50 61 56 56 56 56 56 57 56 56 56 
56 56 56 56 56 56 56 68 59 59 59 59 59 59 69 56 56 56 56 68 59 59 59 59 59 59 69 56 56 56 68 60 50 50 50 50 50 50 58 59 69 56 57 56 56 56 56 56 56 56 
56 56 56 56 56 56 56 56 56 56 56 56 56 56 57 56 56 56 56 56 56 56 56 56 56 56 56 56 57 56 56 68 59 59 59 59 59 59 69 56 56 56 56 56 56 56 56 56 56 56 
56 56 56 56 57 56 56 56 56 56 56 56 56 56 56 56 56 56 56 56 56 56 56 56 56 56 56 56 56 56 56 56 57 56 56 56 56 56 56 57 56 56 56 56 56 56 56 56 56 56 
56 56 56 56 56 56 56 56 56 57 56 56 56 56 56 56 56 56 56 56 56 56 56 57 56 56 56 56 56 56 56 56 56 56 56 56 56 56 56 56 56 56 56 56 56 57 56 56 56 56 
56 56 56 56 56 56 56 56 56 56 56 56 56 56 56 56 56 56 56 56 56 56 56 56 56 56 56 56 56 56 56 56 56 56 56 56 56 56 56 56 56 56 56 56 56 56 56 56 56 56 
56 56 56 56 56 56 56 56 56 56 56 56 56 56 56 56 56 56 56 56 56 56 56 56 56 56 56 56 56 56 56 56 56 56 56 56 56 56 56 56 56 56 56 56 56 56 56 56 56 56 
56 56 56 56 56 56 56 56 56 56 56 56 56 56 56 56 56 56 56 56 56 56 56 56 56 56 56 56 56 56 56 56 56 56 56 56 56 56 56 56 56 56 56 56 56 56 56 56 56 56 